Charger Latitude,Charger Longitude,Hour,Demand Count Near Origin,Demand Count Near Destination,Total Demand Count,lat_lon,id
22.3302116,114.192748,0,809,876,1685,"(22.3302116, 114.192748)",0
22.3302116,114.192748,1,94,1136,1230,"(22.3302116, 114.192748)",0
22.3302116,114.192748,2,0,612,612,"(22.3302116, 114.192748)",0
22.3302116,114.192748,3,153,63,216,"(22.3302116, 114.192748)",0
22.3302116,114.192748,4,808,618,1426,"(22.3302116, 114.192748)",0
22.3302116,114.192748,5,552,402,954,"(22.3302116, 114.192748)",0
22.3302116,114.192748,6,329,253,582,"(22.3302116, 114.192748)",0
22.3302116,114.192748,7,2679,5116,7795,"(22.3302116, 114.192748)",0
22.3302116,114.192748,8,2820,5357,8177,"(22.3302116, 114.192748)",0
22.3302116,114.192748,9,4232,2329,6561,"(22.3302116, 114.192748)",0
22.3302116,114.192748,10,2158,3168,5326,"(22.3302116, 114.192748)",0
22.3302116,114.192748,11,2684,1873,4557,"(22.3302116, 114.192748)",0
22.3302116,114.192748,12,6427,6367,12794,"(22.3302116, 114.192748)",0
22.3302116,114.192748,13,2924,2745,5669,"(22.3302116, 114.192748)",0
22.3302116,114.192748,14,2043,2135,4178,"(22.3302116, 114.192748)",0
22.3302116,114.192748,15,4098,3826,7924,"(22.3302116, 114.192748)",0
22.3302116,114.192748,16,1751,1450,3201,"(22.3302116, 114.192748)",0
22.3302116,114.192748,17,1228,1850,3078,"(22.3302116, 114.192748)",0
22.3302116,114.192748,18,2958,3259,6217,"(22.3302116, 114.192748)",0
22.3302116,114.192748,19,2295,3502,5797,"(22.3302116, 114.192748)",0
22.3302116,114.192748,20,2634,3249,5883,"(22.3302116, 114.192748)",0
22.3302116,114.192748,21,3021,4006,7027,"(22.3302116, 114.192748)",0
22.3302116,114.192748,22,1350,1688,3038,"(22.3302116, 114.192748)",0
22.3302116,114.192748,23,805,1404,2209,"(22.3302116, 114.192748)",0
22.3198503,114.1752856,0,1988,742,2730,"(22.3198503, 114.1752856)",1
22.3198503,114.1752856,1,2134,920,3054,"(22.3198503, 114.1752856)",1
22.3198503,114.1752856,2,1431,1214,2645,"(22.3198503, 114.1752856)",1
22.3198503,114.1752856,3,225,369,594,"(22.3198503, 114.1752856)",1
22.3198503,114.1752856,4,412,605,1017,"(22.3198503, 114.1752856)",1
22.3198503,114.1752856,5,219,564,783,"(22.3198503, 114.1752856)",1
22.3198503,114.1752856,6,832,1193,2025,"(22.3198503, 114.1752856)",1
22.3198503,114.1752856,7,5188,6050,11238,"(22.3198503, 114.1752856)",1
22.3198503,114.1752856,8,5262,6079,11341,"(22.3198503, 114.1752856)",1
22.3198503,114.1752856,9,5863,5379,11242,"(22.3198503, 114.1752856)",1
22.3198503,114.1752856,10,3933,4385,8318,"(22.3198503, 114.1752856)",1
22.3198503,114.1752856,11,4075,2879,6954,"(22.3198503, 114.1752856)",1
22.3198503,114.1752856,12,7117,5331,12448,"(22.3198503, 114.1752856)",1
22.3198503,114.1752856,13,5167,5565,10732,"(22.3198503, 114.1752856)",1
22.3198503,114.1752856,14,3721,4539,8260,"(22.3198503, 114.1752856)",1
22.3198503,114.1752856,15,5538,5300,10838,"(22.3198503, 114.1752856)",1
22.3198503,114.1752856,16,5187,3496,8683,"(22.3198503, 114.1752856)",1
22.3198503,114.1752856,17,2651,4444,7095,"(22.3198503, 114.1752856)",1
22.3198503,114.1752856,18,3865,6517,10382,"(22.3198503, 114.1752856)",1
22.3198503,114.1752856,19,3839,6008,9847,"(22.3198503, 114.1752856)",1
22.3198503,114.1752856,20,3164,3473,6637,"(22.3198503, 114.1752856)",1
22.3198503,114.1752856,21,3712,3375,7087,"(22.3198503, 114.1752856)",1
22.3198503,114.1752856,22,3073,2429,5502,"(22.3198503, 114.1752856)",1
22.3198503,114.1752856,23,2486,2764,5250,"(22.3198503, 114.1752856)",1
22.3007988,114.1790894,0,1502,789,2291,"(22.3007988, 114.1790894)",2
22.3007988,114.1790894,1,1945,111,2056,"(22.3007988, 114.1790894)",2
22.3007988,114.1790894,2,1623,697,2320,"(22.3007988, 114.1790894)",2
22.3007988,114.1790894,3,0,201,201,"(22.3007988, 114.1790894)",2
22.3007988,114.1790894,4,14,431,445,"(22.3007988, 114.1790894)",2
22.3007988,114.1790894,5,191,425,616,"(22.3007988, 114.1790894)",2
22.3007988,114.1790894,6,591,1207,1798,"(22.3007988, 114.1790894)",2
22.3007988,114.1790894,7,2472,3501,5973,"(22.3007988, 114.1790894)",2
22.3007988,114.1790894,8,4169,2904,7073,"(22.3007988, 114.1790894)",2
22.3007988,114.1790894,9,4256,4674,8930,"(22.3007988, 114.1790894)",2
22.3007988,114.1790894,10,1266,2828,4094,"(22.3007988, 114.1790894)",2
22.3007988,114.1790894,11,2084,2858,4942,"(22.3007988, 114.1790894)",2
22.3007988,114.1790894,12,4115,2889,7004,"(22.3007988, 114.1790894)",2
22.3007988,114.1790894,13,2981,4144,7125,"(22.3007988, 114.1790894)",2
22.3007988,114.1790894,14,1607,2765,4372,"(22.3007988, 114.1790894)",2
22.3007988,114.1790894,15,1872,3514,5386,"(22.3007988, 114.1790894)",2
22.3007988,114.1790894,16,2691,1256,3947,"(22.3007988, 114.1790894)",2
22.3007988,114.1790894,17,2887,2131,5018,"(22.3007988, 114.1790894)",2
22.3007988,114.1790894,18,4053,3271,7324,"(22.3007988, 114.1790894)",2
22.3007988,114.1790894,19,3582,3001,6583,"(22.3007988, 114.1790894)",2
22.3007988,114.1790894,20,2031,3369,5400,"(22.3007988, 114.1790894)",2
22.3007988,114.1790894,21,4733,3079,7812,"(22.3007988, 114.1790894)",2
22.3007988,114.1790894,22,1826,380,2206,"(22.3007988, 114.1790894)",2
22.3007988,114.1790894,23,3366,770,4136,"(22.3007988, 114.1790894)",2
22.2994345,114.1736496,0,1578,800,2378,"(22.2994345, 114.1736496)",3
22.2994345,114.1736496,1,1945,0,1945,"(22.2994345, 114.1736496)",3
22.2994345,114.1736496,2,1620,657,2277,"(22.2994345, 114.1736496)",3
22.2994345,114.1736496,3,0,201,201,"(22.2994345, 114.1736496)",3
22.2994345,114.1736496,4,0,405,405,"(22.2994345, 114.1736496)",3
22.2994345,114.1736496,5,5,425,430,"(22.2994345, 114.1736496)",3
22.2994345,114.1736496,6,631,1227,1858,"(22.2994345, 114.1736496)",3
22.2994345,114.1736496,7,2071,2845,4916,"(22.2994345, 114.1736496)",3
22.2994345,114.1736496,8,3751,2558,6309,"(22.2994345, 114.1736496)",3
22.2994345,114.1736496,9,3513,4677,8190,"(22.2994345, 114.1736496)",3
22.2994345,114.1736496,10,1184,2806,3990,"(22.2994345, 114.1736496)",3
22.2994345,114.1736496,11,1926,2796,4722,"(22.2994345, 114.1736496)",3
22.2994345,114.1736496,12,3216,2640,5856,"(22.2994345, 114.1736496)",3
22.2994345,114.1736496,13,2888,3206,6094,"(22.2994345, 114.1736496)",3
22.2994345,114.1736496,14,1630,2176,3806,"(22.2994345, 114.1736496)",3
22.2994345,114.1736496,15,1382,3353,4735,"(22.2994345, 114.1736496)",3
22.2994345,114.1736496,16,2578,1085,3663,"(22.2994345, 114.1736496)",3
22.2994345,114.1736496,17,2995,2017,5012,"(22.2994345, 114.1736496)",3
22.2994345,114.1736496,18,4044,3111,7155,"(22.2994345, 114.1736496)",3
22.2994345,114.1736496,19,3219,3043,6262,"(22.2994345, 114.1736496)",3
22.2994345,114.1736496,20,1966,3075,5041,"(22.2994345, 114.1736496)",3
22.2994345,114.1736496,21,4737,2758,7495,"(22.2994345, 114.1736496)",3
22.2994345,114.1736496,22,1948,378,2326,"(22.2994345, 114.1736496)",3
22.2994345,114.1736496,23,3563,425,3988,"(22.2994345, 114.1736496)",3
22.3208031,114.1626263,0,1856,797,2653,"(22.3208031, 114.1626263)",4
22.3208031,114.1626263,1,1594,562,2156,"(22.3208031, 114.1626263)",4
22.3208031,114.1626263,2,1011,624,1635,"(22.3208031, 114.1626263)",4
22.3208031,114.1626263,3,272,225,497,"(22.3208031, 114.1626263)",4
22.3208031,114.1626263,4,201,404,605,"(22.3208031, 114.1626263)",4
22.3208031,114.1626263,5,96,172,268,"(22.3208031, 114.1626263)",4
22.3208031,114.1626263,6,832,1167,1999,"(22.3208031, 114.1626263)",4
22.3208031,114.1626263,7,4057,3978,8035,"(22.3208031, 114.1626263)",4
22.3208031,114.1626263,8,4607,3490,8097,"(22.3208031, 114.1626263)",4
22.3208031,114.1626263,9,3745,5131,8876,"(22.3208031, 114.1626263)",4
22.3208031,114.1626263,10,3296,2419,5715,"(22.3208031, 114.1626263)",4
22.3208031,114.1626263,11,2971,2144,5115,"(22.3208031, 114.1626263)",4
22.3208031,114.1626263,12,5173,3283,8456,"(22.3208031, 114.1626263)",4
22.3208031,114.1626263,13,5112,3544,8656,"(22.3208031, 114.1626263)",4
22.3208031,114.1626263,14,2299,3378,5677,"(22.3208031, 114.1626263)",4
22.3208031,114.1626263,15,3807,4455,8262,"(22.3208031, 114.1626263)",4
22.3208031,114.1626263,16,4213,2615,6828,"(22.3208031, 114.1626263)",4
22.3208031,114.1626263,17,2175,3594,5769,"(22.3208031, 114.1626263)",4
22.3208031,114.1626263,18,2019,3965,5984,"(22.3208031, 114.1626263)",4
22.3208031,114.1626263,19,3217,4178,7395,"(22.3208031, 114.1626263)",4
22.3208031,114.1626263,20,2227,1213,3440,"(22.3208031, 114.1626263)",4
22.3208031,114.1626263,21,2238,2303,4541,"(22.3208031, 114.1626263)",4
22.3208031,114.1626263,22,2172,1602,3774,"(22.3208031, 114.1626263)",4
22.3208031,114.1626263,23,1631,2307,3938,"(22.3208031, 114.1626263)",4
22.3078513,114.1664406,0,2401,952,3353,"(22.3078513, 114.1664406)",5
22.3078513,114.1664406,1,2453,136,2589,"(22.3078513, 114.1664406)",5
22.3078513,114.1664406,2,2178,646,2824,"(22.3078513, 114.1664406)",5
22.3078513,114.1664406,3,225,229,454,"(22.3078513, 114.1664406)",5
22.3078513,114.1664406,4,0,605,605,"(22.3078513, 114.1664406)",5
22.3078513,114.1664406,5,184,425,609,"(22.3078513, 114.1664406)",5
22.3078513,114.1664406,6,631,1439,2070,"(22.3078513, 114.1664406)",5
22.3078513,114.1664406,7,2655,3707,6362,"(22.3078513, 114.1664406)",5
22.3078513,114.1664406,8,4110,3898,8008,"(22.3078513, 114.1664406)",5
22.3078513,114.1664406,9,3784,6389,10173,"(22.3078513, 114.1664406)",5
22.3078513,114.1664406,10,2977,3182,6159,"(22.3078513, 114.1664406)",5
22.3078513,114.1664406,11,2427,2815,5242,"(22.3078513, 114.1664406)",5
22.3078513,114.1664406,12,4559,2988,7547,"(22.3078513, 114.1664406)",5
22.3078513,114.1664406,13,3145,4280,7425,"(22.3078513, 114.1664406)",5
22.3078513,114.1664406,14,1307,2724,4031,"(22.3078513, 114.1664406)",5
22.3078513,114.1664406,15,2368,4437,6805,"(22.3078513, 114.1664406)",5
22.3078513,114.1664406,16,3411,3028,6439,"(22.3078513, 114.1664406)",5
22.3078513,114.1664406,17,3701,3575,7276,"(22.3078513, 114.1664406)",5
22.3078513,114.1664406,18,3290,4200,7490,"(22.3078513, 114.1664406)",5
22.3078513,114.1664406,19,4058,4791,8849,"(22.3078513, 114.1664406)",5
22.3078513,114.1664406,20,2713,2334,5047,"(22.3078513, 114.1664406)",5
22.3078513,114.1664406,21,3974,2115,6089,"(22.3078513, 114.1664406)",5
22.3078513,114.1664406,22,2281,1446,3727,"(22.3078513, 114.1664406)",5
22.3078513,114.1664406,23,3406,1444,4850,"(22.3078513, 114.1664406)",5
22.3273724,114.1630476,0,1750,795,2545,"(22.3273724, 114.1630476)",6
22.3273724,114.1630476,1,1186,575,1761,"(22.3273724, 114.1630476)",6
22.3273724,114.1630476,2,877,609,1486,"(22.3273724, 114.1630476)",6
22.3273724,114.1630476,3,416,225,641,"(22.3273724, 114.1630476)",6
22.3273724,114.1630476,4,201,404,605,"(22.3273724, 114.1630476)",6
22.3273724,114.1630476,5,60,200,260,"(22.3273724, 114.1630476)",6
22.3273724,114.1630476,6,832,631,1463,"(22.3273724, 114.1630476)",6
22.3273724,114.1630476,7,4420,4122,8542,"(22.3273724, 114.1630476)",6
22.3273724,114.1630476,8,4141,4795,8936,"(22.3273724, 114.1630476)",6
22.3273724,114.1630476,9,3972,5304,9276,"(22.3273724, 114.1630476)",6
22.3273724,114.1630476,10,3733,2298,6031,"(22.3273724, 114.1630476)",6
22.3273724,114.1630476,11,2666,2757,5423,"(22.3273724, 114.1630476)",6
22.3273724,114.1630476,12,4353,4554,8907,"(22.3273724, 114.1630476)",6
22.3273724,114.1630476,13,5030,3888,8918,"(22.3273724, 114.1630476)",6
22.3273724,114.1630476,14,2617,3834,6451,"(22.3273724, 114.1630476)",6
22.3273724,114.1630476,15,4510,5018,9528,"(22.3273724, 114.1630476)",6
22.3273724,114.1630476,16,3973,2783,6756,"(22.3273724, 114.1630476)",6
22.3273724,114.1630476,17,2161,3472,5633,"(22.3273724, 114.1630476)",6
22.3273724,114.1630476,18,1977,4154,6131,"(22.3273724, 114.1630476)",6
22.3273724,114.1630476,19,2802,4747,7549,"(22.3273724, 114.1630476)",6
22.3273724,114.1630476,20,2370,1014,3384,"(22.3273724, 114.1630476)",6
22.3273724,114.1630476,21,1847,2292,4139,"(22.3273724, 114.1630476)",6
22.3273724,114.1630476,22,2197,2123,4320,"(22.3273724, 114.1630476)",6
22.3273724,114.1630476,23,1806,2141,3947,"(22.3273724, 114.1630476)",6
22.3378021,114.1581547,0,818,496,1314,"(22.3378021, 114.1581547)",7
22.3378021,114.1581547,1,561,491,1052,"(22.3378021, 114.1581547)",7
22.3378021,114.1581547,2,518,201,719,"(22.3378021, 114.1581547)",7
22.3378021,114.1581547,3,304,225,529,"(22.3378021, 114.1581547)",7
22.3378021,114.1581547,4,201,19,220,"(22.3378021, 114.1581547)",7
22.3378021,114.1581547,5,206,74,280,"(22.3378021, 114.1581547)",7
22.3378021,114.1581547,6,216,149,365,"(22.3378021, 114.1581547)",7
22.3378021,114.1581547,7,2177,1284,3461,"(22.3378021, 114.1581547)",7
22.3378021,114.1581547,8,2452,1982,4434,"(22.3378021, 114.1581547)",7
22.3378021,114.1581547,9,3237,1557,4794,"(22.3378021, 114.1581547)",7
22.3378021,114.1581547,10,715,336,1051,"(22.3378021, 114.1581547)",7
22.3378021,114.1581547,11,369,997,1366,"(22.3378021, 114.1581547)",7
22.3378021,114.1581547,12,1634,1641,3275,"(22.3378021, 114.1581547)",7
22.3378021,114.1581547,13,2692,2500,5192,"(22.3378021, 114.1581547)",7
22.3378021,114.1581547,14,1833,1851,3684,"(22.3378021, 114.1581547)",7
22.3378021,114.1581547,15,3458,1083,4541,"(22.3378021, 114.1581547)",7
22.3378021,114.1581547,16,1913,896,2809,"(22.3378021, 114.1581547)",7
22.3378021,114.1581547,17,773,1087,1860,"(22.3378021, 114.1581547)",7
22.3378021,114.1581547,18,2004,1701,3705,"(22.3378021, 114.1581547)",7
22.3378021,114.1581547,19,1368,1861,3229,"(22.3378021, 114.1581547)",7
22.3378021,114.1581547,20,490,703,1193,"(22.3378021, 114.1581547)",7
22.3378021,114.1581547,21,1194,953,2147,"(22.3378021, 114.1581547)",7
22.3378021,114.1581547,22,1584,650,2234,"(22.3378021, 114.1581547)",7
22.3378021,114.1581547,23,1006,1817,2823,"(22.3378021, 114.1581547)",7
22.3232465,114.2046191,0,1403,415,1818,"(22.3232465, 114.2046191)",8
22.3232465,114.2046191,1,0,1090,1090,"(22.3232465, 114.2046191)",8
22.3232465,114.2046191,2,0,553,553,"(22.3232465, 114.2046191)",8
22.3232465,114.2046191,3,0,0,0,"(22.3232465, 114.2046191)",8
22.3232465,114.2046191,4,449,404,853,"(22.3232465, 114.2046191)",8
22.3232465,114.2046191,5,375,180,555,"(22.3232465, 114.2046191)",8
22.3232465,114.2046191,6,0,433,433,"(22.3232465, 114.2046191)",8
22.3232465,114.2046191,7,2355,2705,5060,"(22.3232465, 114.2046191)",8
22.3232465,114.2046191,8,1367,3670,5037,"(22.3232465, 114.2046191)",8
22.3232465,114.2046191,9,2413,2610,5023,"(22.3232465, 114.2046191)",8
22.3232465,114.2046191,10,1673,2087,3760,"(22.3232465, 114.2046191)",8
22.3232465,114.2046191,11,624,12,636,"(22.3232465, 114.2046191)",8
22.3232465,114.2046191,12,2828,3807,6635,"(22.3232465, 114.2046191)",8
22.3232465,114.2046191,13,825,1498,2323,"(22.3232465, 114.2046191)",8
22.3232465,114.2046191,14,1542,2062,3604,"(22.3232465, 114.2046191)",8
22.3232465,114.2046191,15,2613,1300,3913,"(22.3232465, 114.2046191)",8
22.3232465,114.2046191,16,1297,1195,2492,"(22.3232465, 114.2046191)",8
22.3232465,114.2046191,17,1455,1513,2968,"(22.3232465, 114.2046191)",8
22.3232465,114.2046191,18,2586,1783,4369,"(22.3232465, 114.2046191)",8
22.3232465,114.2046191,19,1496,1531,3027,"(22.3232465, 114.2046191)",8
22.3232465,114.2046191,20,1764,1866,3630,"(22.3232465, 114.2046191)",8
22.3232465,114.2046191,21,2094,1932,4026,"(22.3232465, 114.2046191)",8
22.3232465,114.2046191,22,570,805,1375,"(22.3232465, 114.2046191)",8
22.3232465,114.2046191,23,599,941,1540,"(22.3232465, 114.2046191)",8
22.3166321,114.1831514,0,1891,982,2873,"(22.3166321, 114.1831514)",9
22.3166321,114.1831514,1,1980,605,2585,"(22.3166321, 114.1831514)",9
22.3166321,114.1831514,2,1643,1391,3034,"(22.3166321, 114.1831514)",9
22.3166321,114.1831514,3,220,201,421,"(22.3166321, 114.1831514)",9
22.3166321,114.1831514,4,318,806,1124,"(22.3166321, 114.1831514)",9
22.3166321,114.1831514,5,219,523,742,"(22.3166321, 114.1831514)",9
22.3166321,114.1831514,6,727,1057,1784,"(22.3166321, 114.1831514)",9
22.3166321,114.1831514,7,5567,5933,11500,"(22.3166321, 114.1831514)",9
22.3166321,114.1831514,8,5359,5804,11163,"(22.3166321, 114.1831514)",9
22.3166321,114.1831514,9,5693,6387,12080,"(22.3166321, 114.1831514)",9
22.3166321,114.1831514,10,3497,4568,8065,"(22.3166321, 114.1831514)",9
22.3166321,114.1831514,11,4641,3578,8219,"(22.3166321, 114.1831514)",9
22.3166321,114.1831514,12,7429,6548,13977,"(22.3166321, 114.1831514)",9
22.3166321,114.1831514,13,6566,4997,11563,"(22.3166321, 114.1831514)",9
22.3166321,114.1831514,14,4245,4353,8598,"(22.3166321, 114.1831514)",9
22.3166321,114.1831514,15,4805,7193,11998,"(22.3166321, 114.1831514)",9
22.3166321,114.1831514,16,4285,3480,7765,"(22.3166321, 114.1831514)",9
22.3166321,114.1831514,17,3643,4635,8278,"(22.3166321, 114.1831514)",9
22.3166321,114.1831514,18,4694,6060,10754,"(22.3166321, 114.1831514)",9
22.3166321,114.1831514,19,4451,5931,10382,"(22.3166321, 114.1831514)",9
22.3166321,114.1831514,20,3679,4361,8040,"(22.3166321, 114.1831514)",9
22.3166321,114.1831514,21,4953,4707,9660,"(22.3166321, 114.1831514)",9
22.3166321,114.1831514,22,2816,1581,4397,"(22.3166321, 114.1831514)",9
22.3166321,114.1831514,23,2608,2281,4889,"(22.3166321, 114.1831514)",9
22.3354512,114.1829159,0,945,414,1359,"(22.3354512, 114.1829159)",10
22.3354512,114.1829159,1,629,674,1303,"(22.3354512, 114.1829159)",10
22.3354512,114.1829159,2,196,618,814,"(22.3354512, 114.1829159)",10
22.3354512,114.1829159,3,202,201,403,"(22.3354512, 114.1829159)",10
22.3354512,114.1829159,4,857,538,1395,"(22.3354512, 114.1829159)",10
22.3354512,114.1829159,5,66,343,409,"(22.3354512, 114.1829159)",10
22.3354512,114.1829159,6,402,432,834,"(22.3354512, 114.1829159)",10
22.3354512,114.1829159,7,4131,3723,7854,"(22.3354512, 114.1829159)",10
22.3354512,114.1829159,8,3336,4345,7681,"(22.3354512, 114.1829159)",10
22.3354512,114.1829159,9,4219,2071,6290,"(22.3354512, 114.1829159)",10
22.3354512,114.1829159,10,2219,2247,4466,"(22.3354512, 114.1829159)",10
22.3354512,114.1829159,11,3091,2783,5874,"(22.3354512, 114.1829159)",10
22.3354512,114.1829159,12,5411,6366,11777,"(22.3354512, 114.1829159)",10
22.3354512,114.1829159,13,4240,2937,7177,"(22.3354512, 114.1829159)",10
22.3354512,114.1829159,14,3112,2150,5262,"(22.3354512, 114.1829159)",10
22.3354512,114.1829159,15,5009,4874,9883,"(22.3354512, 114.1829159)",10
22.3354512,114.1829159,16,1871,2595,4466,"(22.3354512, 114.1829159)",10
22.3354512,114.1829159,17,1036,2284,3320,"(22.3354512, 114.1829159)",10
22.3354512,114.1829159,18,2188,3731,5919,"(22.3354512, 114.1829159)",10
22.3354512,114.1829159,19,2476,4196,6672,"(22.3354512, 114.1829159)",10
22.3354512,114.1829159,20,2740,3120,5860,"(22.3354512, 114.1829159)",10
22.3354512,114.1829159,21,2232,3662,5894,"(22.3354512, 114.1829159)",10
22.3354512,114.1829159,22,2056,1683,3739,"(22.3354512, 114.1829159)",10
22.3354512,114.1829159,23,1582,1512,3094,"(22.3354512, 114.1829159)",10
22.3363635,114.1536869,0,691,586,1277,"(22.3363635, 114.1536869)",11
22.3363635,114.1536869,1,295,566,861,"(22.3363635, 114.1536869)",11
22.3363635,114.1536869,2,603,201,804,"(22.3363635, 114.1536869)",11
22.3363635,114.1536869,3,223,225,448,"(22.3363635, 114.1536869)",11
22.3363635,114.1536869,4,201,2,203,"(22.3363635, 114.1536869)",11
22.3363635,114.1536869,5,206,0,206,"(22.3363635, 114.1536869)",11
22.3363635,114.1536869,6,264,197,461,"(22.3363635, 114.1536869)",11
22.3363635,114.1536869,7,2229,1579,3808,"(22.3363635, 114.1536869)",11
22.3363635,114.1536869,8,2264,2170,4434,"(22.3363635, 114.1536869)",11
22.3363635,114.1536869,9,2974,1908,4882,"(22.3363635, 114.1536869)",11
22.3363635,114.1536869,10,453,223,676,"(22.3363635, 114.1536869)",11
22.3363635,114.1536869,11,200,763,963,"(22.3363635, 114.1536869)",11
22.3363635,114.1536869,12,1700,1729,3429,"(22.3363635, 114.1536869)",11
22.3363635,114.1536869,13,2248,2327,4575,"(22.3363635, 114.1536869)",11
22.3363635,114.1536869,14,1441,1594,3035,"(22.3363635, 114.1536869)",11
22.3363635,114.1536869,15,2066,1330,3396,"(22.3363635, 114.1536869)",11
22.3363635,114.1536869,16,1897,601,2498,"(22.3363635, 114.1536869)",11
22.3363635,114.1536869,17,574,897,1471,"(22.3363635, 114.1536869)",11
22.3363635,114.1536869,18,1893,1439,3332,"(22.3363635, 114.1536869)",11
22.3363635,114.1536869,19,1135,1810,2945,"(22.3363635, 114.1536869)",11
22.3363635,114.1536869,20,304,634,938,"(22.3363635, 114.1536869)",11
22.3363635,114.1536869,21,961,1279,2240,"(22.3363635, 114.1536869)",11
22.3363635,114.1536869,22,706,817,1523,"(22.3363635, 114.1536869)",11
22.3363635,114.1536869,23,861,1586,2447,"(22.3363635, 114.1536869)",11
22.307455,114.1718953,0,2322,1052,3374,"(22.307455, 114.1718953)",12
22.307455,114.1718953,1,2515,57,2572,"(22.307455, 114.1718953)",12
22.307455,114.1718953,2,2239,957,3196,"(22.307455, 114.1718953)",12
22.307455,114.1718953,3,225,201,426,"(22.307455, 114.1718953)",12
22.307455,114.1718953,4,0,687,687,"(22.307455, 114.1718953)",12
22.307455,114.1718953,5,219,425,644,"(22.307455, 114.1718953)",12
22.307455,114.1718953,6,631,1439,2070,"(22.307455, 114.1718953)",12
22.307455,114.1718953,7,4093,4414,8507,"(22.307455, 114.1718953)",12
22.307455,114.1718953,8,5169,4401,9570,"(22.307455, 114.1718953)",12
22.307455,114.1718953,9,5652,7078,12730,"(22.307455, 114.1718953)",12
22.307455,114.1718953,10,2987,4093,7080,"(22.307455, 114.1718953)",12
22.307455,114.1718953,11,3712,3755,7467,"(22.307455, 114.1718953)",12
22.307455,114.1718953,12,6182,4474,10656,"(22.307455, 114.1718953)",12
22.307455,114.1718953,13,5116,5594,10710,"(22.307455, 114.1718953)",12
22.307455,114.1718953,14,1928,3595,5523,"(22.307455, 114.1718953)",12
22.307455,114.1718953,15,2674,5977,8651,"(22.307455, 114.1718953)",12
22.307455,114.1718953,16,4103,3117,7220,"(22.307455, 114.1718953)",12
22.307455,114.1718953,17,4489,4116,8605,"(22.307455, 114.1718953)",12
22.307455,114.1718953,18,4614,5022,9636,"(22.307455, 114.1718953)",12
22.307455,114.1718953,19,5100,5015,10115,"(22.307455, 114.1718953)",12
22.307455,114.1718953,20,3261,3341,6602,"(22.307455, 114.1718953)",12
22.307455,114.1718953,21,5363,3706,9069,"(22.307455, 114.1718953)",12
22.307455,114.1718953,22,2343,1133,3476,"(22.307455, 114.1718953)",12
22.307455,114.1718953,23,3589,1682,5271,"(22.307455, 114.1718953)",12
22.3211383,114.1637496,0,1857,847,2704,"(22.3211383, 114.1637496)",13
22.3211383,114.1637496,1,1599,554,2153,"(22.3211383, 114.1637496)",13
22.3211383,114.1637496,2,1012,624,1636,"(22.3211383, 114.1637496)",13
22.3211383,114.1637496,3,263,225,488,"(22.3211383, 114.1637496)",13
22.3211383,114.1637496,4,201,404,605,"(22.3211383, 114.1637496)",13
22.3211383,114.1637496,5,187,174,361,"(22.3211383, 114.1637496)",13
22.3211383,114.1637496,6,832,1171,2003,"(22.3211383, 114.1637496)",13
22.3211383,114.1637496,7,4195,4530,8725,"(22.3211383, 114.1637496)",13
22.3211383,114.1637496,8,4686,3707,8393,"(22.3211383, 114.1637496)",13
22.3211383,114.1637496,9,3880,5229,9109,"(22.3211383, 114.1637496)",13
22.3211383,114.1637496,10,3367,2597,5964,"(22.3211383, 114.1637496)",13
22.3211383,114.1637496,11,3247,2233,5480,"(22.3211383, 114.1637496)",13
22.3211383,114.1637496,12,5596,3695,9291,"(22.3211383, 114.1637496)",13
22.3211383,114.1637496,13,5485,3694,9179,"(22.3211383, 114.1637496)",13
22.3211383,114.1637496,14,2499,3391,5890,"(22.3211383, 114.1637496)",13
22.3211383,114.1637496,15,4228,4753,8981,"(22.3211383, 114.1637496)",13
22.3211383,114.1637496,16,4279,2640,6919,"(22.3211383, 114.1637496)",13
22.3211383,114.1637496,17,2212,3681,5893,"(22.3211383, 114.1637496)",13
22.3211383,114.1637496,18,2128,4142,6270,"(22.3211383, 114.1637496)",13
22.3211383,114.1637496,19,3444,4369,7813,"(22.3211383, 114.1637496)",13
22.3211383,114.1637496,20,2408,1345,3753,"(22.3211383, 114.1637496)",13
22.3211383,114.1637496,21,2287,2494,4781,"(22.3211383, 114.1637496)",13
22.3211383,114.1637496,22,2172,1723,3895,"(22.3211383, 114.1637496)",13
22.3211383,114.1637496,23,1692,2348,4040,"(22.3211383, 114.1637496)",13
22.3105152,114.18586,0,1916,877,2793,"(22.3105152, 114.18586)",14
22.3105152,114.18586,1,2054,605,2659,"(22.3105152, 114.18586)",14
22.3105152,114.18586,2,1924,1207,3131,"(22.3105152, 114.18586)",14
22.3105152,114.18586,3,4,201,205,"(22.3105152, 114.18586)",14
22.3105152,114.18586,4,211,609,820,"(22.3105152, 114.18586)",14
22.3105152,114.18586,5,219,425,644,"(22.3105152, 114.18586)",14
22.3105152,114.18586,6,605,1175,1780,"(22.3105152, 114.18586)",14
22.3105152,114.18586,7,4551,4074,8625,"(22.3105152, 114.18586)",14
22.3105152,114.18586,8,4366,3608,7974,"(22.3105152, 114.18586)",14
22.3105152,114.18586,9,5763,6520,12283,"(22.3105152, 114.18586)",14
22.3105152,114.18586,10,2614,3220,5834,"(22.3105152, 114.18586)",14
22.3105152,114.18586,11,4232,2824,7056,"(22.3105152, 114.18586)",14
22.3105152,114.18586,12,5984,4746,10730,"(22.3105152, 114.18586)",14
22.3105152,114.18586,13,5645,4611,10256,"(22.3105152, 114.18586)",14
22.3105152,114.18586,14,2562,2769,5331,"(22.3105152, 114.18586)",14
22.3105152,114.18586,15,2543,5419,7962,"(22.3105152, 114.18586)",14
22.3105152,114.18586,16,3281,2126,5407,"(22.3105152, 114.18586)",14
22.3105152,114.18586,17,2899,3435,6334,"(22.3105152, 114.18586)",14
22.3105152,114.18586,18,4603,5172,9775,"(22.3105152, 114.18586)",14
22.3105152,114.18586,19,3691,5114,8805,"(22.3105152, 114.18586)",14
22.3105152,114.18586,20,2485,3728,6213,"(22.3105152, 114.18586)",14
22.3105152,114.18586,21,4568,3903,8471,"(22.3105152, 114.18586)",14
22.3105152,114.18586,22,1989,785,2774,"(22.3105152, 114.18586)",14
22.3105152,114.18586,23,3062,1523,4585,"(22.3105152, 114.18586)",14
22.2967839,114.1745609,0,1574,809,2383,"(22.2967839, 114.1745609)",15
22.2967839,114.1745609,1,1972,0,1972,"(22.2967839, 114.1745609)",15
22.2967839,114.1745609,2,1590,606,2196,"(22.2967839, 114.1745609)",15
22.2967839,114.1745609,3,0,201,201,"(22.2967839, 114.1745609)",15
22.2967839,114.1745609,4,0,359,359,"(22.2967839, 114.1745609)",15
22.2967839,114.1745609,5,0,425,425,"(22.2967839, 114.1745609)",15
22.2967839,114.1745609,6,377,809,1186,"(22.2967839, 114.1745609)",15
22.2967839,114.1745609,7,1967,2438,4405,"(22.2967839, 114.1745609)",15
22.2967839,114.1745609,8,2854,2781,5635,"(22.2967839, 114.1745609)",15
22.2967839,114.1745609,9,2770,4033,6803,"(22.2967839, 114.1745609)",15
22.2967839,114.1745609,10,729,3159,3888,"(22.2967839, 114.1745609)",15
22.2967839,114.1745609,11,1564,2471,4035,"(22.2967839, 114.1745609)",15
22.2967839,114.1745609,12,3048,2728,5776,"(22.2967839, 114.1745609)",15
22.2967839,114.1745609,13,3037,2991,6028,"(22.2967839, 114.1745609)",15
22.2967839,114.1745609,14,1612,2119,3731,"(22.2967839, 114.1745609)",15
22.2967839,114.1745609,15,1305,3245,4550,"(22.2967839, 114.1745609)",15
22.2967839,114.1745609,16,2670,1123,3793,"(22.2967839, 114.1745609)",15
22.2967839,114.1745609,17,3315,1468,4783,"(22.2967839, 114.1745609)",15
22.2967839,114.1745609,18,4290,2647,6937,"(22.2967839, 114.1745609)",15
22.2967839,114.1745609,19,3739,2830,6569,"(22.2967839, 114.1745609)",15
22.2967839,114.1745609,20,1947,3171,5118,"(22.2967839, 114.1745609)",15
22.2967839,114.1745609,21,4872,2431,7303,"(22.2967839, 114.1745609)",15
22.2967839,114.1745609,22,2055,245,2300,"(22.2967839, 114.1745609)",15
22.2967839,114.1745609,23,3294,393,3687,"(22.2967839, 114.1745609)",15
22.307951,114.185723,0,1690,961,2651,"(22.307951, 114.185723)",16
22.307951,114.185723,1,2172,605,2777,"(22.307951, 114.185723)",16
22.307951,114.185723,2,1683,1212,2895,"(22.307951, 114.185723)",16
22.307951,114.185723,3,0,201,201,"(22.307951, 114.185723)",16
22.307951,114.185723,4,211,549,760,"(22.307951, 114.185723)",16
22.307951,114.185723,5,219,425,644,"(22.307951, 114.185723)",16
22.307951,114.185723,6,582,1357,1939,"(22.307951, 114.185723)",16
22.307951,114.185723,7,4244,4410,8654,"(22.307951, 114.185723)",16
22.307951,114.185723,8,4792,3680,8472,"(22.307951, 114.185723)",16
22.307951,114.185723,9,5859,6390,12249,"(22.307951, 114.185723)",16
22.307951,114.185723,10,2539,3364,5903,"(22.307951, 114.185723)",16
22.307951,114.185723,11,3777,3352,7129,"(22.307951, 114.185723)",16
22.307951,114.185723,12,5597,4515,10112,"(22.307951, 114.185723)",16
22.307951,114.185723,13,4931,5022,9953,"(22.307951, 114.185723)",16
22.307951,114.185723,14,2416,2748,5164,"(22.307951, 114.185723)",16
22.307951,114.185723,15,2461,4685,7146,"(22.307951, 114.185723)",16
22.307951,114.185723,16,3138,2221,5359,"(22.307951, 114.185723)",16
22.307951,114.185723,17,2862,3368,6230,"(22.307951, 114.185723)",16
22.307951,114.185723,18,4512,5194,9706,"(22.307951, 114.185723)",16
22.307951,114.185723,19,3835,5111,8946,"(22.307951, 114.185723)",16
22.307951,114.185723,20,2523,4026,6549,"(22.307951, 114.185723)",16
22.307951,114.185723,21,4996,3850,8846,"(22.307951, 114.185723)",16
22.307951,114.185723,22,1926,723,2649,"(22.307951, 114.185723)",16
22.307951,114.185723,23,3257,1347,4604,"(22.307951, 114.185723)",16
22.3222447,114.1812068,0,1753,496,2249,"(22.3222447, 114.1812068)",17
22.3222447,114.1812068,1,1414,733,2147,"(22.3222447, 114.1812068)",17
22.3222447,114.1812068,2,753,1206,1959,"(22.3222447, 114.1812068)",17
22.3222447,114.1812068,3,293,3,296,"(22.3222447, 114.1812068)",17
22.3222447,114.1812068,4,640,605,1245,"(22.3222447, 114.1812068)",17
22.3222447,114.1812068,5,219,305,524,"(22.3222447, 114.1812068)",17
22.3222447,114.1812068,6,832,804,1636,"(22.3222447, 114.1812068)",17
22.3222447,114.1812068,7,5574,6276,11850,"(22.3222447, 114.1812068)",17
22.3222447,114.1812068,8,4569,5967,10536,"(22.3222447, 114.1812068)",17
22.3222447,114.1812068,9,6094,5404,11498,"(22.3222447, 114.1812068)",17
22.3222447,114.1812068,10,3997,3665,7662,"(22.3222447, 114.1812068)",17
22.3222447,114.1812068,11,4062,2954,7016,"(22.3222447, 114.1812068)",17
22.3222447,114.1812068,12,7288,5671,12959,"(22.3222447, 114.1812068)",17
22.3222447,114.1812068,13,5664,4709,10373,"(22.3222447, 114.1812068)",17
22.3222447,114.1812068,14,3988,4072,8060,"(22.3222447, 114.1812068)",17
22.3222447,114.1812068,15,5512,5253,10765,"(22.3222447, 114.1812068)",17
22.3222447,114.1812068,16,4251,3213,7464,"(22.3222447, 114.1812068)",17
22.3222447,114.1812068,17,2353,4045,6398,"(22.3222447, 114.1812068)",17
22.3222447,114.1812068,18,3038,5411,8449,"(22.3222447, 114.1812068)",17
22.3222447,114.1812068,19,3270,4786,8056,"(22.3222447, 114.1812068)",17
22.3222447,114.1812068,20,3497,3006,6503,"(22.3222447, 114.1812068)",17
22.3222447,114.1812068,21,3349,3346,6695,"(22.3222447, 114.1812068)",17
22.3222447,114.1812068,22,2756,1687,4443,"(22.3222447, 114.1812068)",17
22.3222447,114.1812068,23,1785,2428,4213,"(22.3222447, 114.1812068)",17
22.3315551,114.1935562,0,811,1200,2011,"(22.3315551, 114.1935562)",18
22.3315551,114.1935562,1,83,1399,1482,"(22.3315551, 114.1935562)",18
22.3315551,114.1935562,2,0,856,856,"(22.3315551, 114.1935562)",18
22.3315551,114.1935562,3,153,130,283,"(22.3315551, 114.1935562)",18
22.3315551,114.1935562,4,805,618,1423,"(22.3315551, 114.1935562)",18
22.3315551,114.1935562,5,419,562,981,"(22.3315551, 114.1935562)",18
22.3315551,114.1935562,6,429,452,881,"(22.3315551, 114.1935562)",18
22.3315551,114.1935562,7,2829,4937,7766,"(22.3315551, 114.1935562)",18
22.3315551,114.1935562,8,2556,5185,7741,"(22.3315551, 114.1935562)",18
22.3315551,114.1935562,9,4213,2331,6544,"(22.3315551, 114.1935562)",18
22.3315551,114.1935562,10,2181,3236,5417,"(22.3315551, 114.1935562)",18
22.3315551,114.1935562,11,2582,1898,4480,"(22.3315551, 114.1935562)",18
22.3315551,114.1935562,12,5765,6545,12310,"(22.3315551, 114.1935562)",18
22.3315551,114.1935562,13,2634,2406,5040,"(22.3315551, 114.1935562)",18
22.3315551,114.1935562,14,2191,1896,4087,"(22.3315551, 114.1935562)",18
22.3315551,114.1935562,15,3644,3001,6645,"(22.3315551, 114.1935562)",18
22.3315551,114.1935562,16,1948,1522,3470,"(22.3315551, 114.1935562)",18
22.3315551,114.1935562,17,1228,1876,3104,"(22.3315551, 114.1935562)",18
22.3315551,114.1935562,18,2937,3124,6061,"(22.3315551, 114.1935562)",18
22.3315551,114.1935562,19,1928,3277,5205,"(22.3315551, 114.1935562)",18
22.3315551,114.1935562,20,2638,3345,5983,"(22.3315551, 114.1935562)",18
22.3315551,114.1935562,21,3005,4054,7059,"(22.3315551, 114.1935562)",18
22.3315551,114.1935562,22,1310,1912,3222,"(22.3315551, 114.1935562)",18
22.3315551,114.1935562,23,788,1141,1929,"(22.3315551, 114.1935562)",18
22.3220692,114.1888426,0,1023,353,1376,"(22.3220692, 114.1888426)",19
22.3220692,114.1888426,1,561,752,1313,"(22.3220692, 114.1888426)",19
22.3220692,114.1888426,2,575,958,1533,"(22.3220692, 114.1888426)",19
22.3220692,114.1888426,3,4,0,4,"(22.3220692, 114.1888426)",19
22.3220692,114.1888426,4,507,577,1084,"(22.3220692, 114.1888426)",19
22.3220692,114.1888426,5,274,144,418,"(22.3220692, 114.1888426)",19
22.3220692,114.1888426,6,105,578,683,"(22.3220692, 114.1888426)",19
22.3220692,114.1888426,7,4220,4927,9147,"(22.3220692, 114.1888426)",19
22.3220692,114.1888426,8,3849,5298,9147,"(22.3220692, 114.1888426)",19
22.3220692,114.1888426,9,5215,5082,10297,"(22.3220692, 114.1888426)",19
22.3220692,114.1888426,10,2615,3162,5777,"(22.3220692, 114.1888426)",19
22.3220692,114.1888426,11,3664,2456,6120,"(22.3220692, 114.1888426)",19
22.3220692,114.1888426,12,6065,5978,12043,"(22.3220692, 114.1888426)",19
22.3220692,114.1888426,13,4375,3847,8222,"(22.3220692, 114.1888426)",19
22.3220692,114.1888426,14,2633,3030,5663,"(22.3220692, 114.1888426)",19
22.3220692,114.1888426,15,3672,4242,7914,"(22.3220692, 114.1888426)",19
22.3220692,114.1888426,16,2010,2588,4598,"(22.3220692, 114.1888426)",19
22.3220692,114.1888426,17,1374,3085,4459,"(22.3220692, 114.1888426)",19
22.3220692,114.1888426,18,2673,4390,7063,"(22.3220692, 114.1888426)",19
22.3220692,114.1888426,19,2408,3920,6328,"(22.3220692, 114.1888426)",19
22.3220692,114.1888426,20,2765,2535,5300,"(22.3220692, 114.1888426)",19
22.3220692,114.1888426,21,2127,3179,5306,"(22.3220692, 114.1888426)",19
22.3220692,114.1888426,22,987,1547,2534,"(22.3220692, 114.1888426)",19
22.3220692,114.1888426,23,1100,1940,3040,"(22.3220692, 114.1888426)",19
22.301948,114.1748287,0,1823,990,2813,"(22.301948, 114.1748287)",20
22.301948,114.1748287,1,2253,0,2253,"(22.301948, 114.1748287)",20
22.301948,114.1748287,2,1799,804,2603,"(22.301948, 114.1748287)",20
22.301948,114.1748287,3,18,201,219,"(22.301948, 114.1748287)",20
22.301948,114.1748287,4,0,559,559,"(22.301948, 114.1748287)",20
22.301948,114.1748287,5,191,425,616,"(22.301948, 114.1748287)",20
22.301948,114.1748287,6,631,1238,1869,"(22.301948, 114.1748287)",20
22.301948,114.1748287,7,2808,3756,6564,"(22.301948, 114.1748287)",20
22.301948,114.1748287,8,4619,3100,7719,"(22.301948, 114.1748287)",20
22.301948,114.1748287,9,4375,5909,10284,"(22.301948, 114.1748287)",20
22.301948,114.1748287,10,1949,2961,4910,"(22.301948, 114.1748287)",20
22.301948,114.1748287,11,2489,2901,5390,"(22.301948, 114.1748287)",20
22.301948,114.1748287,12,4242,3004,7246,"(22.301948, 114.1748287)",20
22.301948,114.1748287,13,3364,4283,7647,"(22.301948, 114.1748287)",20
22.301948,114.1748287,14,1652,2897,4549,"(22.301948, 114.1748287)",20
22.301948,114.1748287,15,1951,3644,5595,"(22.301948, 114.1748287)",20
22.301948,114.1748287,16,2842,1570,4412,"(22.301948, 114.1748287)",20
22.301948,114.1748287,17,3119,2571,5690,"(22.301948, 114.1748287)",20
22.301948,114.1748287,18,4207,4111,8318,"(22.301948, 114.1748287)",20
22.301948,114.1748287,19,3709,3594,7303,"(22.301948, 114.1748287)",20
22.301948,114.1748287,20,2266,3307,5573,"(22.301948, 114.1748287)",20
22.301948,114.1748287,21,4855,3233,8088,"(22.301948, 114.1748287)",20
22.301948,114.1748287,22,2038,551,2589,"(22.301948, 114.1748287)",20
22.301948,114.1748287,23,3394,720,4114,"(22.301948, 114.1748287)",20
22.3388559,114.2084862,0,977,941,1918,"(22.3388559, 114.2084862)",21
22.3388559,114.2084862,1,0,1183,1183,"(22.3388559, 114.2084862)",21
22.3388559,114.2084862,2,0,573,573,"(22.3388559, 114.2084862)",21
22.3388559,114.2084862,3,0,0,0,"(22.3388559, 114.2084862)",21
22.3388559,114.2084862,4,597,819,1416,"(22.3388559, 114.2084862)",21
22.3388559,114.2084862,5,377,371,748,"(22.3388559, 114.2084862)",21
22.3388559,114.2084862,6,803,980,1783,"(22.3388559, 114.2084862)",21
22.3388559,114.2084862,7,1682,2087,3769,"(22.3388559, 114.2084862)",21
22.3388559,114.2084862,8,1536,1653,3189,"(22.3388559, 114.2084862)",21
22.3388559,114.2084862,9,2878,1305,4183,"(22.3388559, 114.2084862)",21
22.3388559,114.2084862,10,1828,1535,3363,"(22.3388559, 114.2084862)",21
22.3388559,114.2084862,11,946,801,1747,"(22.3388559, 114.2084862)",21
22.3388559,114.2084862,12,3577,3961,7538,"(22.3388559, 114.2084862)",21
22.3388559,114.2084862,13,1220,848,2068,"(22.3388559, 114.2084862)",21
22.3388559,114.2084862,14,663,1049,1712,"(22.3388559, 114.2084862)",21
22.3388559,114.2084862,15,1999,1502,3501,"(22.3388559, 114.2084862)",21
22.3388559,114.2084862,16,1024,1402,2426,"(22.3388559, 114.2084862)",21
22.3388559,114.2084862,17,1317,1171,2488,"(22.3388559, 114.2084862)",21
22.3388559,114.2084862,18,2276,2185,4461,"(22.3388559, 114.2084862)",21
22.3388559,114.2084862,19,1417,1013,2430,"(22.3388559, 114.2084862)",21
22.3388559,114.2084862,20,1249,1378,2627,"(22.3388559, 114.2084862)",21
22.3388559,114.2084862,21,1859,3058,4917,"(22.3388559, 114.2084862)",21
22.3388559,114.2084862,22,884,971,1855,"(22.3388559, 114.2084862)",21
22.3388559,114.2084862,23,797,755,1552,"(22.3388559, 114.2084862)",21
22.3260914,114.1754903,0,1890,765,2655,"(22.3260914, 114.1754903)",22
22.3260914,114.1754903,1,1189,541,1730,"(22.3260914, 114.1754903)",22
22.3260914,114.1754903,2,726,1107,1833,"(22.3260914, 114.1754903)",22
22.3260914,114.1754903,3,426,189,615,"(22.3260914, 114.1754903)",22
22.3260914,114.1754903,4,483,478,961,"(22.3260914, 114.1754903)",22
22.3260914,114.1754903,5,219,346,565,"(22.3260914, 114.1754903)",22
22.3260914,114.1754903,6,832,636,1468,"(22.3260914, 114.1754903)",22
22.3260914,114.1754903,7,5211,6540,11751,"(22.3260914, 114.1754903)",22
22.3260914,114.1754903,8,4990,6523,11513,"(22.3260914, 114.1754903)",22
22.3260914,114.1754903,9,6244,5458,11702,"(22.3260914, 114.1754903)",22
22.3260914,114.1754903,10,4226,3333,7559,"(22.3260914, 114.1754903)",22
22.3260914,114.1754903,11,3847,3192,7039,"(22.3260914, 114.1754903)",22
22.3260914,114.1754903,12,6653,5879,12532,"(22.3260914, 114.1754903)",22
22.3260914,114.1754903,13,5474,5190,10664,"(22.3260914, 114.1754903)",22
22.3260914,114.1754903,14,3609,3826,7435,"(22.3260914, 114.1754903)",22
22.3260914,114.1754903,15,6041,5409,11450,"(22.3260914, 114.1754903)",22
22.3260914,114.1754903,16,4891,3526,8417,"(22.3260914, 114.1754903)",22
22.3260914,114.1754903,17,2246,4679,6925,"(22.3260914, 114.1754903)",22
22.3260914,114.1754903,18,2722,5422,8144,"(22.3260914, 114.1754903)",22
22.3260914,114.1754903,19,3742,5744,9486,"(22.3260914, 114.1754903)",22
22.3260914,114.1754903,20,3562,3414,6976,"(22.3260914, 114.1754903)",22
22.3260914,114.1754903,21,3114,3416,6530,"(22.3260914, 114.1754903)",22
22.3260914,114.1754903,22,2371,2449,4820,"(22.3260914, 114.1754903)",22
22.3260914,114.1754903,23,2201,2880,5081,"(22.3260914, 114.1754903)",22
22.3410076,114.1826856,0,414,800,1214,"(22.3410076, 114.1826856)",23
22.3410076,114.1826856,1,191,631,822,"(22.3410076, 114.1826856)",23
22.3410076,114.1826856,2,58,402,460,"(22.3410076, 114.1826856)",23
22.3410076,114.1826856,3,201,201,402,"(22.3410076, 114.1826856)",23
22.3410076,114.1826856,4,597,508,1105,"(22.3410076, 114.1826856)",23
22.3410076,114.1826856,5,0,532,532,"(22.3410076, 114.1826856)",23
22.3410076,114.1826856,6,221,369,590,"(22.3410076, 114.1826856)",23
22.3410076,114.1826856,7,2509,2818,5327,"(22.3410076, 114.1826856)",23
22.3410076,114.1826856,8,2510,3183,5693,"(22.3410076, 114.1826856)",23
22.3410076,114.1826856,9,3581,1217,4798,"(22.3410076, 114.1826856)",23
22.3410076,114.1826856,10,1423,1874,3297,"(22.3410076, 114.1826856)",23
22.3410076,114.1826856,11,1943,1859,3802,"(22.3410076, 114.1826856)",23
22.3410076,114.1826856,12,3443,5052,8495,"(22.3410076, 114.1826856)",23
22.3410076,114.1826856,13,2025,1332,3357,"(22.3410076, 114.1826856)",23
22.3410076,114.1826856,14,1897,1706,3603,"(22.3410076, 114.1826856)",23
22.3410076,114.1826856,15,3549,2657,6206,"(22.3410076, 114.1826856)",23
22.3410076,114.1826856,16,1240,1107,2347,"(22.3410076, 114.1826856)",23
22.3410076,114.1826856,17,641,1530,2171,"(22.3410076, 114.1826856)",23
22.3410076,114.1826856,18,1833,2373,4206,"(22.3410076, 114.1826856)",23
22.3410076,114.1826856,19,1796,2778,4574,"(22.3410076, 114.1826856)",23
22.3410076,114.1826856,20,2146,2457,4603,"(22.3410076, 114.1826856)",23
22.3410076,114.1826856,21,2239,2958,5197,"(22.3410076, 114.1826856)",23
22.3410076,114.1826856,22,1209,1492,2701,"(22.3410076, 114.1826856)",23
22.3410076,114.1826856,23,1372,413,1785,"(22.3410076, 114.1826856)",23
22.3117888,114.1670317,0,2686,761,3447,"(22.3117888, 114.1670317)",24
22.3117888,114.1670317,1,2633,151,2784,"(22.3117888, 114.1670317)",24
22.3117888,114.1670317,2,2172,646,2818,"(22.3117888, 114.1670317)",24
22.3117888,114.1670317,3,225,408,633,"(22.3117888, 114.1670317)",24
22.3117888,114.1670317,4,201,605,806,"(22.3117888, 114.1670317)",24
22.3117888,114.1670317,5,218,425,643,"(22.3117888, 114.1670317)",24
22.3117888,114.1670317,6,832,1439,2271,"(22.3117888, 114.1670317)",24
22.3117888,114.1670317,7,3352,4175,7527,"(22.3117888, 114.1670317)",24
22.3117888,114.1670317,8,4085,4646,8731,"(22.3117888, 114.1670317)",24
22.3117888,114.1670317,9,4515,6266,10781,"(22.3117888, 114.1670317)",24
22.3117888,114.1670317,10,3099,3478,6577,"(22.3117888, 114.1670317)",24
22.3117888,114.1670317,11,3152,3109,6261,"(22.3117888, 114.1670317)",24
22.3117888,114.1670317,12,5428,3215,8643,"(22.3117888, 114.1670317)",24
22.3117888,114.1670317,13,4245,5689,9934,"(22.3117888, 114.1670317)",24
22.3117888,114.1670317,14,2041,2781,4822,"(22.3117888, 114.1670317)",24
22.3117888,114.1670317,15,3085,4827,7912,"(22.3117888, 114.1670317)",24
22.3117888,114.1670317,16,4261,3475,7736,"(22.3117888, 114.1670317)",24
22.3117888,114.1670317,17,3553,3702,7255,"(22.3117888, 114.1670317)",24
22.3117888,114.1670317,18,3333,4776,8109,"(22.3117888, 114.1670317)",24
22.3117888,114.1670317,19,4548,4842,9390,"(22.3117888, 114.1670317)",24
22.3117888,114.1670317,20,2895,2066,4961,"(22.3117888, 114.1670317)",24
22.3117888,114.1670317,21,3921,2920,6841,"(22.3117888, 114.1670317)",24
22.3117888,114.1670317,22,2771,1659,4430,"(22.3117888, 114.1670317)",24
22.3117888,114.1670317,23,3199,2199,5398,"(22.3117888, 114.1670317)",24
22.3373473,114.2010372,0,1012,1149,2161,"(22.3373473, 114.2010372)",25
22.3373473,114.2010372,1,0,1206,1206,"(22.3373473, 114.2010372)",25
22.3373473,114.2010372,2,0,675,675,"(22.3373473, 114.2010372)",25
22.3373473,114.2010372,3,4,201,205,"(22.3373473, 114.2010372)",25
22.3373473,114.2010372,4,618,618,1236,"(22.3373473, 114.2010372)",25
22.3373473,114.2010372,5,377,371,748,"(22.3373473, 114.2010372)",25
22.3373473,114.2010372,6,803,622,1425,"(22.3373473, 114.2010372)",25
22.3373473,114.2010372,7,2156,2198,4354,"(22.3373473, 114.2010372)",25
22.3373473,114.2010372,8,1636,2889,4525,"(22.3373473, 114.2010372)",25
22.3373473,114.2010372,9,2724,1718,4442,"(22.3373473, 114.2010372)",25
22.3373473,114.2010372,10,1791,2056,3847,"(22.3373473, 114.2010372)",25
22.3373473,114.2010372,11,1203,802,2005,"(22.3373473, 114.2010372)",25
22.3373473,114.2010372,12,3634,4598,8232,"(22.3373473, 114.2010372)",25
22.3373473,114.2010372,13,1132,812,1944,"(22.3373473, 114.2010372)",25
22.3373473,114.2010372,14,1112,1224,2336,"(22.3373473, 114.2010372)",25
22.3373473,114.2010372,15,2127,1605,3732,"(22.3373473, 114.2010372)",25
22.3373473,114.2010372,16,828,1697,2525,"(22.3373473, 114.2010372)",25
22.3373473,114.2010372,17,1036,1550,2586,"(22.3373473, 114.2010372)",25
22.3373473,114.2010372,18,2580,1602,4182,"(22.3373473, 114.2010372)",25
22.3373473,114.2010372,19,1854,1630,3484,"(22.3373473, 114.2010372)",25
22.3373473,114.2010372,20,1563,1946,3509,"(22.3373473, 114.2010372)",25
22.3373473,114.2010372,21,2469,3271,5740,"(22.3373473, 114.2010372)",25
22.3373473,114.2010372,22,1010,1530,2540,"(22.3373473, 114.2010372)",25
22.3373473,114.2010372,23,879,762,1641,"(22.3373473, 114.2010372)",25
22.3204837,114.1899997,0,805,277,1082,"(22.3204837, 114.1899997)",26
22.3204837,114.1899997,1,340,647,987,"(22.3204837, 114.1899997)",26
22.3204837,114.1899997,2,477,994,1471,"(22.3204837, 114.1899997)",26
22.3204837,114.1899997,3,2,0,2,"(22.3204837, 114.1899997)",26
22.3204837,114.1899997,4,476,543,1019,"(22.3204837, 114.1899997)",26
22.3204837,114.1899997,5,312,144,456,"(22.3204837, 114.1899997)",26
22.3204837,114.1899997,6,51,326,377,"(22.3204837, 114.1899997)",26
22.3204837,114.1899997,7,4166,4821,8987,"(22.3204837, 114.1899997)",26
22.3204837,114.1899997,8,3755,4851,8606,"(22.3204837, 114.1899997)",26
22.3204837,114.1899997,9,5201,4907,10108,"(22.3204837, 114.1899997)",26
22.3204837,114.1899997,10,2484,3217,5701,"(22.3204837, 114.1899997)",26
22.3204837,114.1899997,11,3332,2189,5521,"(22.3204837, 114.1899997)",26
22.3204837,114.1899997,12,5809,6152,11961,"(22.3204837, 114.1899997)",26
22.3204837,114.1899997,13,4309,3434,7743,"(22.3204837, 114.1899997)",26
22.3204837,114.1899997,14,2551,2910,5461,"(22.3204837, 114.1899997)",26
22.3204837,114.1899997,15,3352,4175,7527,"(22.3204837, 114.1899997)",26
22.3204837,114.1899997,16,2031,2211,4242,"(22.3204837, 114.1899997)",26
22.3204837,114.1899997,17,1179,2747,3926,"(22.3204837, 114.1899997)",26
22.3204837,114.1899997,18,2701,4157,6858,"(22.3204837, 114.1899997)",26
22.3204837,114.1899997,19,1955,4094,6049,"(22.3204837, 114.1899997)",26
22.3204837,114.1899997,20,2625,2393,5018,"(22.3204837, 114.1899997)",26
22.3204837,114.1899997,21,2038,3211,5249,"(22.3204837, 114.1899997)",26
22.3204837,114.1899997,22,705,1490,2195,"(22.3204837, 114.1899997)",26
22.3204837,114.1899997,23,1057,1632,2689,"(22.3204837, 114.1899997)",26
22.3090254,114.1687897,0,2478,1091,3569,"(22.3090254, 114.1687897)",27
22.3090254,114.1687897,1,2549,136,2685,"(22.3090254, 114.1687897)",27
22.3090254,114.1687897,2,2187,663,2850,"(22.3090254, 114.1687897)",27
22.3090254,114.1687897,3,225,228,453,"(22.3090254, 114.1687897)",27
22.3090254,114.1687897,4,103,605,708,"(22.3090254, 114.1687897)",27
22.3090254,114.1687897,5,218,425,643,"(22.3090254, 114.1687897)",27
22.3090254,114.1687897,6,723,1439,2162,"(22.3090254, 114.1687897)",27
22.3090254,114.1687897,7,3122,4064,7186,"(22.3090254, 114.1687897)",27
22.3090254,114.1687897,8,4237,4481,8718,"(22.3090254, 114.1687897)",27
22.3090254,114.1687897,9,4434,6775,11209,"(22.3090254, 114.1687897)",27
22.3090254,114.1687897,10,3051,3570,6621,"(22.3090254, 114.1687897)",27
22.3090254,114.1687897,11,2873,3138,6011,"(22.3090254, 114.1687897)",27
22.3090254,114.1687897,12,5554,3475,9029,"(22.3090254, 114.1687897)",27
22.3090254,114.1687897,13,3844,5415,9259,"(22.3090254, 114.1687897)",27
22.3090254,114.1687897,14,1690,2829,4519,"(22.3090254, 114.1687897)",27
22.3090254,114.1687897,15,2993,5519,8512,"(22.3090254, 114.1687897)",27
22.3090254,114.1687897,16,3588,3396,6984,"(22.3090254, 114.1687897)",27
22.3090254,114.1687897,17,3856,3814,7670,"(22.3090254, 114.1687897)",27
22.3090254,114.1687897,18,3462,4840,8302,"(22.3090254, 114.1687897)",27
22.3090254,114.1687897,19,4219,4977,9196,"(22.3090254, 114.1687897)",27
22.3090254,114.1687897,20,2867,2672,5539,"(22.3090254, 114.1687897)",27
22.3090254,114.1687897,21,4103,2875,6978,"(22.3090254, 114.1687897)",27
22.3090254,114.1687897,22,2686,1447,4133,"(22.3090254, 114.1687897)",27
22.3090254,114.1687897,23,3406,2128,5534,"(22.3090254, 114.1687897)",27
22.3395703,114.1805543,0,665,455,1120,"(22.3395703, 114.1805543)",28
22.3395703,114.1805543,1,437,608,1045,"(22.3395703, 114.1805543)",28
22.3395703,114.1805543,2,54,402,456,"(22.3395703, 114.1805543)",28
22.3395703,114.1805543,3,201,201,402,"(22.3395703, 114.1805543)",28
22.3395703,114.1805543,4,772,508,1280,"(22.3395703, 114.1805543)",28
22.3395703,114.1805543,5,1,348,349,"(22.3395703, 114.1805543)",28
22.3395703,114.1805543,6,395,223,618,"(22.3395703, 114.1805543)",28
22.3395703,114.1805543,7,2809,3001,5810,"(22.3395703, 114.1805543)",28
22.3395703,114.1805543,8,2631,3978,6609,"(22.3395703, 114.1805543)",28
22.3395703,114.1805543,9,2969,1423,4392,"(22.3395703, 114.1805543)",28
22.3395703,114.1805543,10,1332,2122,3454,"(22.3395703, 114.1805543)",28
22.3395703,114.1805543,11,2585,2334,4919,"(22.3395703, 114.1805543)",28
22.3395703,114.1805543,12,3967,4768,8735,"(22.3395703, 114.1805543)",28
22.3395703,114.1805543,13,3315,2342,5657,"(22.3395703, 114.1805543)",28
22.3395703,114.1805543,14,2648,1968,4616,"(22.3395703, 114.1805543)",28
22.3395703,114.1805543,15,3977,3253,7230,"(22.3395703, 114.1805543)",28
22.3395703,114.1805543,16,1493,1685,3178,"(22.3395703, 114.1805543)",28
22.3395703,114.1805543,17,787,1645,2432,"(22.3395703, 114.1805543)",28
22.3395703,114.1805543,18,1998,2953,4951,"(22.3395703, 114.1805543)",28
22.3395703,114.1805543,19,1577,2788,4365,"(22.3395703, 114.1805543)",28
22.3395703,114.1805543,20,2267,2668,4935,"(22.3395703, 114.1805543)",28
22.3395703,114.1805543,21,1824,3081,4905,"(22.3395703, 114.1805543)",28
22.3395703,114.1805543,22,1967,1418,3385,"(22.3395703, 114.1805543)",28
22.3395703,114.1805543,23,1535,1257,2792,"(22.3395703, 114.1805543)",28
22.3010328,114.1764341,0,1650,910,2560,"(22.3010328, 114.1764341)",29
22.3010328,114.1764341,1,2088,0,2088,"(22.3010328, 114.1764341)",29
22.3010328,114.1764341,2,1695,804,2499,"(22.3010328, 114.1764341)",29
22.3010328,114.1764341,3,0,201,201,"(22.3010328, 114.1764341)",29
22.3010328,114.1764341,4,0,482,482,"(22.3010328, 114.1764341)",29
22.3010328,114.1764341,5,182,425,607,"(22.3010328, 114.1764341)",29
22.3010328,114.1764341,6,631,1227,1858,"(22.3010328, 114.1764341)",29
22.3010328,114.1764341,7,2570,3596,6166,"(22.3010328, 114.1764341)",29
22.3010328,114.1764341,8,4231,2998,7229,"(22.3010328, 114.1764341)",29
22.3010328,114.1764341,9,4243,5468,9711,"(22.3010328, 114.1764341)",29
22.3010328,114.1764341,10,1598,2859,4457,"(22.3010328, 114.1764341)",29
22.3010328,114.1764341,11,2263,2853,5116,"(22.3010328, 114.1764341)",29
22.3010328,114.1764341,12,4084,2916,7000,"(22.3010328, 114.1764341)",29
22.3010328,114.1764341,13,3151,4233,7384,"(22.3010328, 114.1764341)",29
22.3010328,114.1764341,14,1630,2861,4491,"(22.3010328, 114.1764341)",29
22.3010328,114.1764341,15,1855,3571,5426,"(22.3010328, 114.1764341)",29
22.3010328,114.1764341,16,2706,1394,4100,"(22.3010328, 114.1764341)",29
22.3010328,114.1764341,17,2984,2293,5277,"(22.3010328, 114.1764341)",29
22.3010328,114.1764341,18,4102,3726,7828,"(22.3010328, 114.1764341)",29
22.3010328,114.1764341,19,3560,3375,6935,"(22.3010328, 114.1764341)",29
22.3010328,114.1764341,20,2119,3334,5453,"(22.3010328, 114.1764341)",29
22.3010328,114.1764341,21,4788,3109,7897,"(22.3010328, 114.1764341)",29
22.3010328,114.1764341,22,1948,447,2395,"(22.3010328, 114.1764341)",29
22.3010328,114.1764341,23,3461,703,4164,"(22.3010328, 114.1764341)",29
22.3241413,114.1613777,0,1714,698,2412,"(22.3241413, 114.1613777)",30
22.3241413,114.1613777,1,1116,583,1699,"(22.3241413, 114.1613777)",30
22.3241413,114.1613777,2,842,609,1451,"(22.3241413, 114.1613777)",30
22.3241413,114.1613777,3,363,225,588,"(22.3241413, 114.1613777)",30
22.3241413,114.1613777,4,201,404,605,"(22.3241413, 114.1613777)",30
22.3241413,114.1613777,5,19,7,26,"(22.3241413, 114.1613777)",30
22.3241413,114.1613777,6,832,672,1504,"(22.3241413, 114.1613777)",30
22.3241413,114.1613777,7,4167,3189,7356,"(22.3241413, 114.1613777)",30
22.3241413,114.1613777,8,3985,3530,7515,"(22.3241413, 114.1613777)",30
22.3241413,114.1613777,9,3400,5155,8555,"(22.3241413, 114.1613777)",30
22.3241413,114.1613777,10,3390,1621,5011,"(22.3241413, 114.1613777)",30
22.3241413,114.1613777,11,2305,2124,4429,"(22.3241413, 114.1613777)",30
22.3241413,114.1613777,12,3748,3663,7411,"(22.3241413, 114.1613777)",30
22.3241413,114.1613777,13,4461,3339,7800,"(22.3241413, 114.1613777)",30
22.3241413,114.1613777,14,2205,3345,5550,"(22.3241413, 114.1613777)",30
22.3241413,114.1613777,15,3704,4610,8314,"(22.3241413, 114.1613777)",30
22.3241413,114.1613777,16,3742,2598,6340,"(22.3241413, 114.1613777)",30
22.3241413,114.1613777,17,2089,3330,5419,"(22.3241413, 114.1613777)",30
22.3241413,114.1613777,18,1537,3504,5041,"(22.3241413, 114.1613777)",30
22.3241413,114.1613777,19,2661,4086,6747,"(22.3241413, 114.1613777)",30
22.3241413,114.1613777,20,1871,613,2484,"(22.3241413, 114.1613777)",30
22.3241413,114.1613777,21,1657,1876,3533,"(22.3241413, 114.1613777)",30
22.3241413,114.1613777,22,1835,1703,3538,"(22.3241413, 114.1613777)",30
22.3241413,114.1613777,23,1687,2152,3839,"(22.3241413, 114.1613777)",30
22.3095873,114.1838606,0,2316,1008,3324,"(22.3095873, 114.1838606)",31
22.3095873,114.1838606,1,2480,605,3085,"(22.3095873, 114.1838606)",31
22.3095873,114.1838606,2,2164,1212,3376,"(22.3095873, 114.1838606)",31
22.3095873,114.1838606,3,25,201,226,"(22.3095873, 114.1838606)",31
22.3095873,114.1838606,4,211,674,885,"(22.3095873, 114.1838606)",31
22.3095873,114.1838606,5,219,425,644,"(22.3095873, 114.1838606)",31
22.3095873,114.1838606,6,631,1420,2051,"(22.3095873, 114.1838606)",31
22.3095873,114.1838606,7,4566,4986,9552,"(22.3095873, 114.1838606)",31
22.3095873,114.1838606,8,5193,4513,9706,"(22.3095873, 114.1838606)",31
22.3095873,114.1838606,9,6056,7132,13188,"(22.3095873, 114.1838606)",31
22.3095873,114.1838606,10,2781,4046,6827,"(22.3095873, 114.1838606)",31
22.3095873,114.1838606,11,4428,3558,7986,"(22.3095873, 114.1838606)",31
22.3095873,114.1838606,12,6246,4919,11165,"(22.3095873, 114.1838606)",31
22.3095873,114.1838606,13,5829,5492,11321,"(22.3095873, 114.1838606)",31
22.3095873,114.1838606,14,2537,3077,5614,"(22.3095873, 114.1838606)",31
22.3095873,114.1838606,15,2986,5731,8717,"(22.3095873, 114.1838606)",31
22.3095873,114.1838606,16,3523,2633,6156,"(22.3095873, 114.1838606)",31
22.3095873,114.1838606,17,3746,3847,7593,"(22.3095873, 114.1838606)",31
22.3095873,114.1838606,18,4997,5776,10773,"(22.3095873, 114.1838606)",31
22.3095873,114.1838606,19,4340,5541,9881,"(22.3095873, 114.1838606)",31
22.3095873,114.1838606,20,3164,4140,7304,"(22.3095873, 114.1838606)",31
22.3095873,114.1838606,21,5265,4137,9402,"(22.3095873, 114.1838606)",31
22.3095873,114.1838606,22,2157,869,3026,"(22.3095873, 114.1838606)",31
22.3095873,114.1838606,23,3604,1700,5304,"(22.3095873, 114.1838606)",31
22.3262109,114.1645027,0,1699,797,2496,"(22.3262109, 114.1645027)",32
22.3262109,114.1645027,1,1186,575,1761,"(22.3262109, 114.1645027)",32
22.3262109,114.1645027,2,827,609,1436,"(22.3262109, 114.1645027)",32
22.3262109,114.1645027,3,349,225,574,"(22.3262109, 114.1645027)",32
22.3262109,114.1645027,4,201,404,605,"(22.3262109, 114.1645027)",32
22.3262109,114.1645027,5,54,202,256,"(22.3262109, 114.1645027)",32
22.3262109,114.1645027,6,832,649,1481,"(22.3262109, 114.1645027)",32
22.3262109,114.1645027,7,4440,4665,9105,"(22.3262109, 114.1645027)",32
22.3262109,114.1645027,8,4234,4963,9197,"(22.3262109, 114.1645027)",32
22.3262109,114.1645027,9,4359,5550,9909,"(22.3262109, 114.1645027)",32
22.3262109,114.1645027,10,3741,2516,6257,"(22.3262109, 114.1645027)",32
22.3262109,114.1645027,11,3066,2922,5988,"(22.3262109, 114.1645027)",32
22.3262109,114.1645027,12,4669,4507,9176,"(22.3262109, 114.1645027)",32
22.3262109,114.1645027,13,5213,4080,9293,"(22.3262109, 114.1645027)",32
22.3262109,114.1645027,14,2552,3841,6393,"(22.3262109, 114.1645027)",32
22.3262109,114.1645027,15,4649,5001,9650,"(22.3262109, 114.1645027)",32
22.3262109,114.1645027,16,4123,2819,6942,"(22.3262109, 114.1645027)",32
22.3262109,114.1645027,17,2093,3745,5838,"(22.3262109, 114.1645027)",32
22.3262109,114.1645027,18,1910,4706,6616,"(22.3262109, 114.1645027)",32
22.3262109,114.1645027,19,2861,4859,7720,"(22.3262109, 114.1645027)",32
22.3262109,114.1645027,20,2445,1122,3567,"(22.3262109, 114.1645027)",32
22.3262109,114.1645027,21,1889,2486,4375,"(22.3262109, 114.1645027)",32
22.3262109,114.1645027,22,2197,2122,4319,"(22.3262109, 114.1645027)",32
22.3262109,114.1645027,23,1806,2172,3978,"(22.3262109, 114.1645027)",32
22.3195108,114.1869571,0,1379,605,1984,"(22.3195108, 114.1869571)",33
22.3195108,114.1869571,1,941,611,1552,"(22.3195108, 114.1869571)",33
22.3195108,114.1869571,2,701,998,1699,"(22.3195108, 114.1869571)",33
22.3195108,114.1869571,3,20,0,20,"(22.3195108, 114.1869571)",33
22.3195108,114.1869571,4,421,692,1113,"(22.3195108, 114.1869571)",33
22.3195108,114.1869571,5,219,187,406,"(22.3195108, 114.1869571)",33
22.3195108,114.1869571,6,458,712,1170,"(22.3195108, 114.1869571)",33
22.3195108,114.1869571,7,4257,5220,9477,"(22.3195108, 114.1869571)",33
22.3195108,114.1869571,8,3711,5131,8842,"(22.3195108, 114.1869571)",33
22.3195108,114.1869571,9,5117,5342,10459,"(22.3195108, 114.1869571)",33
22.3195108,114.1869571,10,2839,3331,6170,"(22.3195108, 114.1869571)",33
22.3195108,114.1869571,11,3763,2725,6488,"(22.3195108, 114.1869571)",33
22.3195108,114.1869571,12,6126,5792,11918,"(22.3195108, 114.1869571)",33
22.3195108,114.1869571,13,5255,3962,9217,"(22.3195108, 114.1869571)",33
22.3195108,114.1869571,14,3442,3088,6530,"(22.3195108, 114.1869571)",33
22.3195108,114.1869571,15,4165,4865,9030,"(22.3195108, 114.1869571)",33
22.3195108,114.1869571,16,2460,2971,5431,"(22.3195108, 114.1869571)",33
22.3195108,114.1869571,17,1632,3665,5297,"(22.3195108, 114.1869571)",33
22.3195108,114.1869571,18,3060,4439,7499,"(22.3195108, 114.1869571)",33
22.3195108,114.1869571,19,2199,4769,6968,"(22.3195108, 114.1869571)",33
22.3195108,114.1869571,20,2894,2732,5626,"(22.3195108, 114.1869571)",33
22.3195108,114.1869571,21,2207,3278,5485,"(22.3195108, 114.1869571)",33
22.3195108,114.1869571,22,1579,1570,3149,"(22.3195108, 114.1869571)",33
22.3195108,114.1869571,23,1295,2127,3422,"(22.3195108, 114.1869571)",33
22.3322428,114.1653177,0,1587,742,2329,"(22.3322428, 114.1653177)",34
22.3322428,114.1653177,1,1186,531,1717,"(22.3322428, 114.1653177)",34
22.3322428,114.1653177,2,814,609,1423,"(22.3322428, 114.1653177)",34
22.3322428,114.1653177,3,469,225,694,"(22.3322428, 114.1653177)",34
22.3322428,114.1653177,4,201,404,605,"(22.3322428, 114.1653177)",34
22.3322428,114.1653177,5,64,341,405,"(22.3322428, 114.1653177)",34
22.3322428,114.1653177,6,371,631,1002,"(22.3322428, 114.1653177)",34
22.3322428,114.1653177,7,4365,3768,8133,"(22.3322428, 114.1653177)",34
22.3322428,114.1653177,8,3239,4684,7923,"(22.3322428, 114.1653177)",34
22.3322428,114.1653177,9,4163,4576,8739,"(22.3322428, 114.1653177)",34
22.3322428,114.1653177,10,3240,2343,5583,"(22.3322428, 114.1653177)",34
22.3322428,114.1653177,11,2306,2870,5176,"(22.3322428, 114.1653177)",34
22.3322428,114.1653177,12,4664,5058,9722,"(22.3322428, 114.1653177)",34
22.3322428,114.1653177,13,5114,3905,9019,"(22.3322428, 114.1653177)",34
22.3322428,114.1653177,14,2695,3577,6272,"(22.3322428, 114.1653177)",34
22.3322428,114.1653177,15,4551,4831,9382,"(22.3322428, 114.1653177)",34
22.3322428,114.1653177,16,3658,2721,6379,"(22.3322428, 114.1653177)",34
22.3322428,114.1653177,17,2135,3574,5709,"(22.3322428, 114.1653177)",34
22.3322428,114.1653177,18,1999,4224,6223,"(22.3322428, 114.1653177)",34
22.3322428,114.1653177,19,2903,4739,7642,"(22.3322428, 114.1653177)",34
22.3322428,114.1653177,20,2459,1633,4092,"(22.3322428, 114.1653177)",34
22.3322428,114.1653177,21,1846,2284,4130,"(22.3322428, 114.1653177)",34
22.3322428,114.1653177,22,2197,1995,4192,"(22.3322428, 114.1653177)",34
22.3322428,114.1653177,23,1314,2111,3425,"(22.3322428, 114.1653177)",34
22.3185673,114.1796057,0,1945,815,2760,"(22.3185673, 114.1796057)",35
22.3185673,114.1796057,1,2070,631,2701,"(22.3185673, 114.1796057)",35
22.3185673,114.1796057,2,1394,1427,2821,"(22.3185673, 114.1796057)",35
22.3185673,114.1796057,3,225,206,431,"(22.3185673, 114.1796057)",35
22.3185673,114.1796057,4,412,785,1197,"(22.3185673, 114.1796057)",35
22.3185673,114.1796057,5,219,560,779,"(22.3185673, 114.1796057)",35
22.3185673,114.1796057,6,832,1133,1965,"(22.3185673, 114.1796057)",35
22.3185673,114.1796057,7,5463,5945,11408,"(22.3185673, 114.1796057)",35
22.3185673,114.1796057,8,4874,5794,10668,"(22.3185673, 114.1796057)",35
22.3185673,114.1796057,9,6060,5723,11783,"(22.3185673, 114.1796057)",35
22.3185673,114.1796057,10,3770,4563,8333,"(22.3185673, 114.1796057)",35
22.3185673,114.1796057,11,4013,3107,7120,"(22.3185673, 114.1796057)",35
22.3185673,114.1796057,12,7122,5981,13103,"(22.3185673, 114.1796057)",35
22.3185673,114.1796057,13,5686,5164,10850,"(22.3185673, 114.1796057)",35
22.3185673,114.1796057,14,4211,4446,8657,"(22.3185673, 114.1796057)",35
22.3185673,114.1796057,15,5002,5910,10912,"(22.3185673, 114.1796057)",35
22.3185673,114.1796057,16,4661,3230,7891,"(22.3185673, 114.1796057)",35
22.3185673,114.1796057,17,2762,4464,7226,"(22.3185673, 114.1796057)",35
22.3185673,114.1796057,18,4074,6558,10632,"(22.3185673, 114.1796057)",35
22.3185673,114.1796057,19,3373,5826,9199,"(22.3185673, 114.1796057)",35
22.3185673,114.1796057,20,3461,3545,7006,"(22.3185673, 114.1796057)",35
22.3185673,114.1796057,21,3982,3611,7593,"(22.3185673, 114.1796057)",35
22.3185673,114.1796057,22,2689,1883,4572,"(22.3185673, 114.1796057)",35
22.3185673,114.1796057,23,2557,2525,5082,"(22.3185673, 114.1796057)",35
22.3231171,114.1636602,0,1721,815,2536,"(22.3231171, 114.1636602)",36
22.3231171,114.1636602,1,1237,580,1817,"(22.3231171, 114.1636602)",36
22.3231171,114.1636602,2,847,609,1456,"(22.3231171, 114.1636602)",36
22.3231171,114.1636602,3,280,225,505,"(22.3231171, 114.1636602)",36
22.3231171,114.1636602,4,201,404,605,"(22.3231171, 114.1636602)",36
22.3231171,114.1636602,5,125,36,161,"(22.3231171, 114.1636602)",36
22.3231171,114.1636602,6,832,752,1584,"(22.3231171, 114.1636602)",36
22.3231171,114.1636602,7,4336,4787,9123,"(22.3231171, 114.1636602)",36
22.3231171,114.1636602,8,4328,4202,8530,"(22.3231171, 114.1636602)",36
22.3231171,114.1636602,9,3891,5450,9341,"(22.3231171, 114.1636602)",36
22.3231171,114.1636602,10,3522,2177,5699,"(22.3231171, 114.1636602)",36
22.3231171,114.1636602,11,2915,2410,5325,"(22.3231171, 114.1636602)",36
22.3231171,114.1636602,12,4667,4088,8755,"(22.3231171, 114.1636602)",36
22.3231171,114.1636602,13,4902,3937,8839,"(22.3231171, 114.1636602)",36
22.3231171,114.1636602,14,2312,3750,6062,"(22.3231171, 114.1636602)",36
22.3231171,114.1636602,15,4336,4994,9330,"(22.3231171, 114.1636602)",36
22.3231171,114.1636602,16,4133,2713,6846,"(22.3231171, 114.1636602)",36
22.3231171,114.1636602,17,2096,3662,5758,"(22.3231171, 114.1636602)",36
22.3231171,114.1636602,18,1671,4454,6125,"(22.3231171, 114.1636602)",36
22.3231171,114.1636602,19,2852,4651,7503,"(22.3231171, 114.1636602)",36
22.3231171,114.1636602,20,2239,1090,3329,"(22.3231171, 114.1636602)",36
22.3231171,114.1636602,21,1979,2307,4286,"(22.3231171, 114.1636602)",36
22.3231171,114.1636602,22,2104,1925,4029,"(22.3231171, 114.1636602)",36
22.3231171,114.1636602,23,1729,2206,3935,"(22.3231171, 114.1636602)",36
22.3186438,114.1740588,0,1890,775,2665,"(22.3186438, 114.1740588)",37
22.3186438,114.1740588,1,2095,901,2996,"(22.3186438, 114.1740588)",37
22.3186438,114.1740588,2,1523,1214,2737,"(22.3186438, 114.1740588)",37
22.3186438,114.1740588,3,225,380,605,"(22.3186438, 114.1740588)",37
22.3186438,114.1740588,4,401,605,1006,"(22.3186438, 114.1740588)",37
22.3186438,114.1740588,5,219,569,788,"(22.3186438, 114.1740588)",37
22.3186438,114.1740588,6,832,1224,2056,"(22.3186438, 114.1740588)",37
22.3186438,114.1740588,7,5182,5728,10910,"(22.3186438, 114.1740588)",37
22.3186438,114.1740588,8,5152,5603,10755,"(22.3186438, 114.1740588)",37
22.3186438,114.1740588,9,5986,5623,11609,"(22.3186438, 114.1740588)",37
22.3186438,114.1740588,10,3814,4157,7971,"(22.3186438, 114.1740588)",37
22.3186438,114.1740588,11,3849,2927,6776,"(22.3186438, 114.1740588)",37
22.3186438,114.1740588,12,7071,4976,12047,"(22.3186438, 114.1740588)",37
22.3186438,114.1740588,13,5092,5694,10786,"(22.3186438, 114.1740588)",37
22.3186438,114.1740588,14,3633,4471,8104,"(22.3186438, 114.1740588)",37
22.3186438,114.1740588,15,5230,5335,10565,"(22.3186438, 114.1740588)",37
22.3186438,114.1740588,16,5154,3191,8345,"(22.3186438, 114.1740588)",37
22.3186438,114.1740588,17,2863,4174,7037,"(22.3186438, 114.1740588)",37
22.3186438,114.1740588,18,3848,6483,10331,"(22.3186438, 114.1740588)",37
22.3186438,114.1740588,19,3778,5911,9689,"(22.3186438, 114.1740588)",37
22.3186438,114.1740588,20,3152,3337,6489,"(22.3186438, 114.1740588)",37
22.3186438,114.1740588,21,3485,3175,6660,"(22.3186438, 114.1740588)",37
22.3186438,114.1740588,22,2576,2216,4792,"(22.3186438, 114.1740588)",37
22.3186438,114.1740588,23,2355,2694,5049,"(22.3186438, 114.1740588)",37
22.3191173,114.1686812,0,1932,809,2741,"(22.3191173, 114.1686812)",38
22.3191173,114.1686812,1,1905,336,2241,"(22.3191173, 114.1686812)",38
22.3191173,114.1686812,2,1276,814,2090,"(22.3191173, 114.1686812)",38
22.3191173,114.1686812,3,225,426,651,"(22.3191173, 114.1686812)",38
22.3191173,114.1686812,4,201,605,806,"(22.3191173, 114.1686812)",38
22.3191173,114.1686812,5,219,439,658,"(22.3191173, 114.1686812)",38
22.3191173,114.1686812,6,832,1224,2056,"(22.3191173, 114.1686812)",38
22.3191173,114.1686812,7,4426,5671,10097,"(22.3191173, 114.1686812)",38
22.3191173,114.1686812,8,5046,5063,10109,"(22.3191173, 114.1686812)",38
22.3191173,114.1686812,9,5038,5343,10381,"(22.3191173, 114.1686812)",38
22.3191173,114.1686812,10,3533,3782,7315,"(22.3191173, 114.1686812)",38
22.3191173,114.1686812,11,3711,2590,6301,"(22.3191173, 114.1686812)",38
22.3191173,114.1686812,12,6857,4648,11505,"(22.3191173, 114.1686812)",38
22.3191173,114.1686812,13,5466,5401,10867,"(22.3191173, 114.1686812)",38
22.3191173,114.1686812,14,2923,4079,7002,"(22.3191173, 114.1686812)",38
22.3191173,114.1686812,15,4901,5220,10121,"(22.3191173, 114.1686812)",38
22.3191173,114.1686812,16,5096,2935,8031,"(22.3191173, 114.1686812)",38
22.3191173,114.1686812,17,2584,3821,6405,"(22.3191173, 114.1686812)",38
22.3191173,114.1686812,18,3299,6112,9411,"(22.3191173, 114.1686812)",38
22.3191173,114.1686812,19,3606,5269,8875,"(22.3191173, 114.1686812)",38
22.3191173,114.1686812,20,2964,2614,5578,"(22.3191173, 114.1686812)",38
22.3191173,114.1686812,21,2862,2932,5794,"(22.3191173, 114.1686812)",38
22.3191173,114.1686812,22,2466,1894,4360,"(22.3191173, 114.1686812)",38
22.3191173,114.1686812,23,2147,2885,5032,"(22.3191173, 114.1686812)",38
22.2969266,114.174573,0,1572,802,2374,"(22.2969266, 114.174573)",39
22.2969266,114.174573,1,1946,0,1946,"(22.2969266, 114.174573)",39
22.2969266,114.174573,2,1590,606,2196,"(22.2969266, 114.174573)",39
22.2969266,114.174573,3,0,201,201,"(22.2969266, 114.174573)",39
22.2969266,114.174573,4,0,381,381,"(22.2969266, 114.174573)",39
22.2969266,114.174573,5,0,425,425,"(22.2969266, 114.174573)",39
22.2969266,114.174573,6,377,808,1185,"(22.2969266, 114.174573)",39
22.2969266,114.174573,7,1960,2423,4383,"(22.2969266, 114.174573)",39
22.2969266,114.174573,8,2995,2736,5731,"(22.2969266, 114.174573)",39
22.2969266,114.174573,9,2916,4022,6938,"(22.2969266, 114.174573)",39
22.2969266,114.174573,10,712,3057,3769,"(22.2969266, 114.174573)",39
22.2969266,114.174573,11,1577,2464,4041,"(22.2969266, 114.174573)",39
22.2969266,114.174573,12,3059,2653,5712,"(22.2969266, 114.174573)",39
22.2969266,114.174573,13,3006,2977,5983,"(22.2969266, 114.174573)",39
22.2969266,114.174573,14,1593,2104,3697,"(22.2969266, 114.174573)",39
22.2969266,114.174573,15,1296,3208,4504,"(22.2969266, 114.174573)",39
22.2969266,114.174573,16,2593,1081,3674,"(22.2969266, 114.174573)",39
22.2969266,114.174573,17,3303,1467,4770,"(22.2969266, 114.174573)",39
22.2969266,114.174573,18,4279,2601,6880,"(22.2969266, 114.174573)",39
22.2969266,114.174573,19,3630,2829,6459,"(22.2969266, 114.174573)",39
22.2969266,114.174573,20,1927,3127,5054,"(22.2969266, 114.174573)",39
22.2969266,114.174573,21,4841,2423,7264,"(22.2969266, 114.174573)",39
22.2969266,114.174573,22,2033,249,2282,"(22.2969266, 114.174573)",39
22.2969266,114.174573,23,3307,393,3700,"(22.2969266, 114.174573)",39
22.3112227,114.1697312,0,2686,1082,3768,"(22.3112227, 114.1697312)",40
22.3112227,114.1697312,1,2705,136,2841,"(22.3112227, 114.1697312)",40
22.3112227,114.1697312,2,2178,666,2844,"(22.3112227, 114.1697312)",40
22.3112227,114.1697312,3,225,356,581,"(22.3112227, 114.1697312)",40
22.3112227,114.1697312,4,201,605,806,"(22.3112227, 114.1697312)",40
22.3112227,114.1697312,5,219,425,644,"(22.3112227, 114.1697312)",40
22.3112227,114.1697312,6,832,1439,2271,"(22.3112227, 114.1697312)",40
22.3112227,114.1697312,7,3519,4460,7979,"(22.3112227, 114.1697312)",40
22.3112227,114.1697312,8,4366,4912,9278,"(22.3112227, 114.1697312)",40
22.3112227,114.1697312,9,5606,6936,12542,"(22.3112227, 114.1697312)",40
22.3112227,114.1697312,10,3163,3825,6988,"(22.3112227, 114.1697312)",40
22.3112227,114.1697312,11,3491,3333,6824,"(22.3112227, 114.1697312)",40
22.3112227,114.1697312,12,6389,3854,10243,"(22.3112227, 114.1697312)",40
22.3112227,114.1697312,13,4694,6548,11242,"(22.3112227, 114.1697312)",40
22.3112227,114.1697312,14,2145,3162,5307,"(22.3112227, 114.1697312)",40
22.3112227,114.1697312,15,3177,5821,8998,"(22.3112227, 114.1697312)",40
22.3112227,114.1697312,16,4359,3590,7949,"(22.3112227, 114.1697312)",40
22.3112227,114.1697312,17,3821,4008,7829,"(22.3112227, 114.1697312)",40
22.3112227,114.1697312,18,3914,5145,9059,"(22.3112227, 114.1697312)",40
22.3112227,114.1697312,19,4558,5110,9668,"(22.3112227, 114.1697312)",40
22.3112227,114.1697312,20,3075,2618,5693,"(22.3112227, 114.1697312)",40
22.3112227,114.1697312,21,4243,3200,7443,"(22.3112227, 114.1697312)",40
22.3112227,114.1697312,22,2787,1662,4449,"(22.3112227, 114.1697312)",40
22.3112227,114.1697312,23,3502,2501,6003,"(22.3112227, 114.1697312)",40
22.335982,114.1977818,0,947,1252,2199,"(22.335982, 114.1977818)",41
22.335982,114.1977818,1,1,1286,1287,"(22.335982, 114.1977818)",41
22.335982,114.1977818,2,0,863,863,"(22.335982, 114.1977818)",41
22.335982,114.1977818,3,76,201,277,"(22.335982, 114.1977818)",41
22.335982,114.1977818,4,678,618,1296,"(22.335982, 114.1977818)",41
22.335982,114.1977818,5,377,569,946,"(22.335982, 114.1977818)",41
22.335982,114.1977818,6,803,599,1402,"(22.335982, 114.1977818)",41
22.335982,114.1977818,7,2622,3835,6457,"(22.335982, 114.1977818)",41
22.335982,114.1977818,8,2026,4206,6232,"(22.335982, 114.1977818)",41
22.335982,114.1977818,9,3250,1889,5139,"(22.335982, 114.1977818)",41
22.335982,114.1977818,10,2104,2727,4831,"(22.335982, 114.1977818)",41
22.335982,114.1977818,11,1417,1515,2932,"(22.335982, 114.1977818)",41
22.335982,114.1977818,12,4223,5388,9611,"(22.335982, 114.1977818)",41
22.335982,114.1977818,13,1390,1191,2581,"(22.335982, 114.1977818)",41
22.335982,114.1977818,14,1600,1695,3295,"(22.335982, 114.1977818)",41
22.335982,114.1977818,15,2527,2083,4610,"(22.335982, 114.1977818)",41
22.335982,114.1977818,16,1366,1865,3231,"(22.335982, 114.1977818)",41
22.335982,114.1977818,17,1138,1658,2796,"(22.335982, 114.1977818)",41
22.335982,114.1977818,18,2721,2533,5254,"(22.335982, 114.1977818)",41
22.335982,114.1977818,19,1980,2528,4508,"(22.335982, 114.1977818)",41
22.335982,114.1977818,20,1964,2869,4833,"(22.335982, 114.1977818)",41
22.335982,114.1977818,21,2571,3926,6497,"(22.335982, 114.1977818)",41
22.335982,114.1977818,22,1010,1904,2914,"(22.335982, 114.1977818)",41
22.335982,114.1977818,23,884,843,1727,"(22.335982, 114.1977818)",41
22.265841,114.1875712,0,831,446,1277,"(22.265841, 114.1875712)",42
22.265841,114.1875712,1,714,382,1096,"(22.265841, 114.1875712)",42
22.265841,114.1875712,2,63,208,271,"(22.265841, 114.1875712)",42
22.265841,114.1875712,3,0,0,0,"(22.265841, 114.1875712)",42
22.265841,114.1875712,4,1169,1169,2338,"(22.265841, 114.1875712)",42
22.265841,114.1875712,5,0,0,0,"(22.265841, 114.1875712)",42
22.265841,114.1875712,6,315,406,721,"(22.265841, 114.1875712)",42
22.265841,114.1875712,7,1680,1238,2918,"(22.265841, 114.1875712)",42
22.265841,114.1875712,8,3270,3466,6736,"(22.265841, 114.1875712)",42
22.265841,114.1875712,9,1279,1850,3129,"(22.265841, 114.1875712)",42
22.265841,114.1875712,10,2766,4154,6920,"(22.265841, 114.1875712)",42
22.265841,114.1875712,11,2131,1237,3368,"(22.265841, 114.1875712)",42
22.265841,114.1875712,12,2129,3350,5479,"(22.265841, 114.1875712)",42
22.265841,114.1875712,13,3954,4053,8007,"(22.265841, 114.1875712)",42
22.265841,114.1875712,14,2752,1783,4535,"(22.265841, 114.1875712)",42
22.265841,114.1875712,15,2030,1372,3402,"(22.265841, 114.1875712)",42
22.265841,114.1875712,16,3153,2572,5725,"(22.265841, 114.1875712)",42
22.265841,114.1875712,17,3672,2352,6024,"(22.265841, 114.1875712)",42
22.265841,114.1875712,18,2624,4439,7063,"(22.265841, 114.1875712)",42
22.265841,114.1875712,19,3227,5353,8580,"(22.265841, 114.1875712)",42
22.265841,114.1875712,20,1541,2219,3760,"(22.265841, 114.1875712)",42
22.265841,114.1875712,21,1453,1235,2688,"(22.265841, 114.1875712)",42
22.265841,114.1875712,22,2932,777,3709,"(22.265841, 114.1875712)",42
22.265841,114.1875712,23,1126,615,1741,"(22.265841, 114.1875712)",42
22.2786297,114.1918383,0,1099,466,1565,"(22.2786297, 114.1918383)",43
22.2786297,114.1918383,1,724,566,1290,"(22.2786297, 114.1918383)",43
22.2786297,114.1918383,2,0,204,204,"(22.2786297, 114.1918383)",43
22.2786297,114.1918383,3,0,0,0,"(22.2786297, 114.1918383)",43
22.2786297,114.1918383,4,1169,1169,2338,"(22.2786297, 114.1918383)",43
22.2786297,114.1918383,5,0,0,0,"(22.2786297, 114.1918383)",43
22.2786297,114.1918383,6,878,380,1258,"(22.2786297, 114.1918383)",43
22.2786297,114.1918383,7,3643,1297,4940,"(22.2786297, 114.1918383)",43
22.2786297,114.1918383,8,4710,4272,8982,"(22.2786297, 114.1918383)",43
22.2786297,114.1918383,9,1773,2255,4028,"(22.2786297, 114.1918383)",43
22.2786297,114.1918383,10,3872,4183,8055,"(22.2786297, 114.1918383)",43
22.2786297,114.1918383,11,3658,2794,6452,"(22.2786297, 114.1918383)",43
22.2786297,114.1918383,12,2108,3759,5867,"(22.2786297, 114.1918383)",43
22.2786297,114.1918383,13,4065,4473,8538,"(22.2786297, 114.1918383)",43
22.2786297,114.1918383,14,3085,1893,4978,"(22.2786297, 114.1918383)",43
22.2786297,114.1918383,15,2438,1990,4428,"(22.2786297, 114.1918383)",43
22.2786297,114.1918383,16,3411,3630,7041,"(22.2786297, 114.1918383)",43
22.2786297,114.1918383,17,3891,2800,6691,"(22.2786297, 114.1918383)",43
22.2786297,114.1918383,18,3540,5182,8722,"(22.2786297, 114.1918383)",43
22.2786297,114.1918383,19,3715,6921,10636,"(22.2786297, 114.1918383)",43
22.2786297,114.1918383,20,1724,3340,5064,"(22.2786297, 114.1918383)",43
22.2786297,114.1918383,21,1874,1311,3185,"(22.2786297, 114.1918383)",43
22.2786297,114.1918383,22,2700,744,3444,"(22.2786297, 114.1918383)",43
22.2786297,114.1918383,23,1146,812,1958,"(22.2786297, 114.1918383)",43
22.2762828,114.1795503,0,1018,623,1641,"(22.2762828, 114.1795503)",44
22.2762828,114.1795503,1,1227,401,1628,"(22.2762828, 114.1795503)",44
22.2762828,114.1795503,2,6,208,214,"(22.2762828, 114.1795503)",44
22.2762828,114.1795503,3,0,0,0,"(22.2762828, 114.1795503)",44
22.2762828,114.1795503,4,1169,1169,2338,"(22.2762828, 114.1795503)",44
22.2762828,114.1795503,5,0,0,0,"(22.2762828, 114.1795503)",44
22.2762828,114.1795503,6,379,408,787,"(22.2762828, 114.1795503)",44
22.2762828,114.1795503,7,1964,2155,4119,"(22.2762828, 114.1795503)",44
22.2762828,114.1795503,8,3648,5021,8669,"(22.2762828, 114.1795503)",44
22.2762828,114.1795503,9,1344,2703,4047,"(22.2762828, 114.1795503)",44
22.2762828,114.1795503,10,3517,5254,8771,"(22.2762828, 114.1795503)",44
22.2762828,114.1795503,11,2282,2335,4617,"(22.2762828, 114.1795503)",44
22.2762828,114.1795503,12,2678,4307,6985,"(22.2762828, 114.1795503)",44
22.2762828,114.1795503,13,4447,4382,8829,"(22.2762828, 114.1795503)",44
22.2762828,114.1795503,14,2845,1935,4780,"(22.2762828, 114.1795503)",44
22.2762828,114.1795503,15,1916,2803,4719,"(22.2762828, 114.1795503)",44
22.2762828,114.1795503,16,3447,2824,6271,"(22.2762828, 114.1795503)",44
22.2762828,114.1795503,17,4403,2463,6866,"(22.2762828, 114.1795503)",44
22.2762828,114.1795503,18,4379,4484,8863,"(22.2762828, 114.1795503)",44
22.2762828,114.1795503,19,5332,5537,10869,"(22.2762828, 114.1795503)",44
22.2762828,114.1795503,20,2758,2995,5753,"(22.2762828, 114.1795503)",44
22.2762828,114.1795503,21,2399,1273,3672,"(22.2762828, 114.1795503)",44
22.2762828,114.1795503,22,3662,593,4255,"(22.2762828, 114.1795503)",44
22.2762828,114.1795503,23,1804,615,2419,"(22.2762828, 114.1795503)",44
22.2904085,114.1951268,0,642,593,1235,"(22.2904085, 114.1951268)",45
22.2904085,114.1951268,1,680,373,1053,"(22.2904085, 114.1951268)",45
22.2904085,114.1951268,2,278,368,646,"(22.2904085, 114.1951268)",45
22.2904085,114.1951268,3,0,0,0,"(22.2904085, 114.1951268)",45
22.2904085,114.1951268,4,3,1370,1373,"(22.2904085, 114.1951268)",45
22.2904085,114.1951268,5,0,0,0,"(22.2904085, 114.1951268)",45
22.2904085,114.1951268,6,622,0,622,"(22.2904085, 114.1951268)",45
22.2904085,114.1951268,7,3988,1284,5272,"(22.2904085, 114.1951268)",45
22.2904085,114.1951268,8,3574,3716,7290,"(22.2904085, 114.1951268)",45
22.2904085,114.1951268,9,1849,2956,4805,"(22.2904085, 114.1951268)",45
22.2904085,114.1951268,10,2812,2542,5354,"(22.2904085, 114.1951268)",45
22.2904085,114.1951268,11,2595,3140,5735,"(22.2904085, 114.1951268)",45
22.2904085,114.1951268,12,902,2949,3851,"(22.2904085, 114.1951268)",45
22.2904085,114.1951268,13,3368,3360,6728,"(22.2904085, 114.1951268)",45
22.2904085,114.1951268,14,2938,1020,3958,"(22.2904085, 114.1951268)",45
22.2904085,114.1951268,15,1576,3979,5555,"(22.2904085, 114.1951268)",45
22.2904085,114.1951268,16,3280,3059,6339,"(22.2904085, 114.1951268)",45
22.2904085,114.1951268,17,2897,2357,5254,"(22.2904085, 114.1951268)",45
22.2904085,114.1951268,18,3469,2733,6202,"(22.2904085, 114.1951268)",45
22.2904085,114.1951268,19,3426,3809,7235,"(22.2904085, 114.1951268)",45
22.2904085,114.1951268,20,1602,3414,5016,"(22.2904085, 114.1951268)",45
22.2904085,114.1951268,21,3180,2522,5702,"(22.2904085, 114.1951268)",45
22.2904085,114.1951268,22,1327,242,1569,"(22.2904085, 114.1951268)",45
22.2904085,114.1951268,23,548,613,1161,"(22.2904085, 114.1951268)",45
22.2828762,114.1277959,0,327,327,654,"(22.2828762, 114.1277959)",46
22.2828762,114.1277959,1,25,232,257,"(22.2828762, 114.1277959)",46
22.2828762,114.1277959,2,0,0,0,"(22.2828762, 114.1277959)",46
22.2828762,114.1277959,3,0,0,0,"(22.2828762, 114.1277959)",46
22.2828762,114.1277959,4,209,0,209,"(22.2828762, 114.1277959)",46
22.2828762,114.1277959,5,0,0,0,"(22.2828762, 114.1277959)",46
22.2828762,114.1277959,6,224,441,665,"(22.2828762, 114.1277959)",46
22.2828762,114.1277959,7,889,415,1304,"(22.2828762, 114.1277959)",46
22.2828762,114.1277959,8,3117,18,3135,"(22.2828762, 114.1277959)",46
22.2828762,114.1277959,9,1680,479,2159,"(22.2828762, 114.1277959)",46
22.2828762,114.1277959,10,1127,624,1751,"(22.2828762, 114.1277959)",46
22.2828762,114.1277959,11,642,124,766,"(22.2828762, 114.1277959)",46
22.2828762,114.1277959,12,2300,1480,3780,"(22.2828762, 114.1277959)",46
22.2828762,114.1277959,13,1984,2203,4187,"(22.2828762, 114.1277959)",46
22.2828762,114.1277959,14,583,195,778,"(22.2828762, 114.1277959)",46
22.2828762,114.1277959,15,971,803,1774,"(22.2828762, 114.1277959)",46
22.2828762,114.1277959,16,11,303,314,"(22.2828762, 114.1277959)",46
22.2828762,114.1277959,17,812,2001,2813,"(22.2828762, 114.1277959)",46
22.2828762,114.1277959,18,1133,3682,4815,"(22.2828762, 114.1277959)",46
22.2828762,114.1277959,19,1120,1881,3001,"(22.2828762, 114.1277959)",46
22.2828762,114.1277959,20,683,553,1236,"(22.2828762, 114.1277959)",46
22.2828762,114.1277959,21,1282,1781,3063,"(22.2828762, 114.1277959)",46
22.2828762,114.1277959,22,191,440,631,"(22.2828762, 114.1277959)",46
22.2828762,114.1277959,23,421,440,861,"(22.2828762, 114.1277959)",46
22.291298,114.211641,0,201,196,397,"(22.291298, 114.211641)",47
22.291298,114.211641,1,0,599,599,"(22.291298, 114.211641)",47
22.291298,114.211641,2,0,228,228,"(22.291298, 114.211641)",47
22.291298,114.211641,3,0,0,0,"(22.291298, 114.211641)",47
22.291298,114.211641,4,0,0,0,"(22.291298, 114.211641)",47
22.291298,114.211641,5,0,4,4,"(22.291298, 114.211641)",47
22.291298,114.211641,6,1000,0,1000,"(22.291298, 114.211641)",47
22.291298,114.211641,7,4050,573,4623,"(22.291298, 114.211641)",47
22.291298,114.211641,8,3766,2692,6458,"(22.291298, 114.211641)",47
22.291298,114.211641,9,781,978,1759,"(22.291298, 114.211641)",47
22.291298,114.211641,10,2291,203,2494,"(22.291298, 114.211641)",47
22.291298,114.211641,11,2145,2238,4383,"(22.291298, 114.211641)",47
22.291298,114.211641,12,406,844,1250,"(22.291298, 114.211641)",47
22.291298,114.211641,13,224,1714,1938,"(22.291298, 114.211641)",47
22.291298,114.211641,14,681,1053,1734,"(22.291298, 114.211641)",47
22.291298,114.211641,15,462,1429,1891,"(22.291298, 114.211641)",47
22.291298,114.211641,16,1543,1126,2669,"(22.291298, 114.211641)",47
22.291298,114.211641,17,299,1538,1837,"(22.291298, 114.211641)",47
22.291298,114.211641,18,1806,1546,3352,"(22.291298, 114.211641)",47
22.291298,114.211641,19,745,2481,3226,"(22.291298, 114.211641)",47
22.291298,114.211641,20,2068,1573,3641,"(22.291298, 114.211641)",47
22.291298,114.211641,21,1159,1370,2529,"(22.291298, 114.211641)",47
22.291298,114.211641,22,391,1396,1787,"(22.291298, 114.211641)",47
22.291298,114.211641,23,0,1204,1204,"(22.291298, 114.211641)",47
22.2809696,114.230195,0,0,196,196,"(22.2809696, 114.230195)",50
22.2809696,114.230195,1,0,415,415,"(22.2809696, 114.230195)",50
22.2809696,114.230195,2,0,228,228,"(22.2809696, 114.230195)",50
22.2809696,114.230195,3,0,0,0,"(22.2809696, 114.230195)",50
22.2809696,114.230195,4,0,0,0,"(22.2809696, 114.230195)",50
22.2809696,114.230195,5,0,183,183,"(22.2809696, 114.230195)",50
22.2809696,114.230195,6,379,224,603,"(22.2809696, 114.230195)",50
22.2809696,114.230195,7,2163,581,2744,"(22.2809696, 114.230195)",50
22.2809696,114.230195,8,2439,992,3431,"(22.2809696, 114.230195)",50
22.2809696,114.230195,9,1202,390,1592,"(22.2809696, 114.230195)",50
22.2809696,114.230195,10,837,179,1016,"(22.2809696, 114.230195)",50
22.2809696,114.230195,11,646,912,1558,"(22.2809696, 114.230195)",50
22.2809696,114.230195,12,847,1213,2060,"(22.2809696, 114.230195)",50
22.2809696,114.230195,13,450,1223,1673,"(22.2809696, 114.230195)",50
22.2809696,114.230195,14,235,945,1180,"(22.2809696, 114.230195)",50
22.2809696,114.230195,15,1093,891,1984,"(22.2809696, 114.230195)",50
22.2809696,114.230195,16,1036,259,1295,"(22.2809696, 114.230195)",50
22.2809696,114.230195,17,228,1845,2073,"(22.2809696, 114.230195)",50
22.2809696,114.230195,18,698,1030,1728,"(22.2809696, 114.230195)",50
22.2809696,114.230195,19,687,1276,1963,"(22.2809696, 114.230195)",50
22.2809696,114.230195,20,1355,945,2300,"(22.2809696, 114.230195)",50
22.2809696,114.230195,21,632,2190,2822,"(22.2809696, 114.230195)",50
22.2809696,114.230195,22,571,1793,2364,"(22.2809696, 114.230195)",50
22.2809696,114.230195,23,0,1324,1324,"(22.2809696, 114.230195)",50
22.2920209,114.2014289,0,201,310,511,"(22.2920209, 114.2014289)",49
22.2920209,114.2014289,1,172,745,917,"(22.2920209, 114.2014289)",49
22.2920209,114.2014289,2,166,556,722,"(22.2920209, 114.2014289)",49
22.2920209,114.2014289,3,0,0,0,"(22.2920209, 114.2014289)",49
22.2920209,114.2014289,4,0,260,260,"(22.2920209, 114.2014289)",49
22.2920209,114.2014289,5,0,0,0,"(22.2920209, 114.2014289)",49
22.2920209,114.2014289,6,860,0,860,"(22.2920209, 114.2014289)",49
22.2920209,114.2014289,7,4666,671,5337,"(22.2920209, 114.2014289)",49
22.2920209,114.2014289,8,3382,3030,6412,"(22.2920209, 114.2014289)",49
22.2920209,114.2014289,9,1196,1685,2881,"(22.2920209, 114.2014289)",49
22.2920209,114.2014289,10,2562,829,3391,"(22.2920209, 114.2014289)",49
22.2920209,114.2014289,11,2697,3043,5740,"(22.2920209, 114.2014289)",49
22.2920209,114.2014289,12,652,2148,2800,"(22.2920209, 114.2014289)",49
22.2920209,114.2014289,13,1668,1955,3623,"(22.2920209, 114.2014289)",49
22.2920209,114.2014289,14,1747,998,2745,"(22.2920209, 114.2014289)",49
22.2920209,114.2014289,15,1106,2780,3886,"(22.2920209, 114.2014289)",49
22.2920209,114.2014289,16,2185,1587,3772,"(22.2920209, 114.2014289)",49
22.2920209,114.2014289,17,1638,1858,3496,"(22.2920209, 114.2014289)",49
22.2920209,114.2014289,18,2366,1584,3950,"(22.2920209, 114.2014289)",49
22.2920209,114.2014289,19,1596,3515,5111,"(22.2920209, 114.2014289)",49
22.2920209,114.2014289,20,1991,2480,4471,"(22.2920209, 114.2014289)",49
22.2920209,114.2014289,21,2522,2438,4960,"(22.2920209, 114.2014289)",49
22.2920209,114.2014289,22,537,826,1363,"(22.2920209, 114.2014289)",49
22.2920209,114.2014289,23,0,1115,1115,"(22.2920209, 114.2014289)",49
22.2809696,114.230195,0,0,196,196,"(22.2809696, 114.230195)",50
22.2809696,114.230195,1,0,415,415,"(22.2809696, 114.230195)",50
22.2809696,114.230195,2,0,228,228,"(22.2809696, 114.230195)",50
22.2809696,114.230195,3,0,0,0,"(22.2809696, 114.230195)",50
22.2809696,114.230195,4,0,0,0,"(22.2809696, 114.230195)",50
22.2809696,114.230195,5,0,183,183,"(22.2809696, 114.230195)",50
22.2809696,114.230195,6,379,224,603,"(22.2809696, 114.230195)",50
22.2809696,114.230195,7,2163,581,2744,"(22.2809696, 114.230195)",50
22.2809696,114.230195,8,2439,992,3431,"(22.2809696, 114.230195)",50
22.2809696,114.230195,9,1202,390,1592,"(22.2809696, 114.230195)",50
22.2809696,114.230195,10,837,179,1016,"(22.2809696, 114.230195)",50
22.2809696,114.230195,11,646,912,1558,"(22.2809696, 114.230195)",50
22.2809696,114.230195,12,847,1213,2060,"(22.2809696, 114.230195)",50
22.2809696,114.230195,13,450,1223,1673,"(22.2809696, 114.230195)",50
22.2809696,114.230195,14,235,945,1180,"(22.2809696, 114.230195)",50
22.2809696,114.230195,15,1093,891,1984,"(22.2809696, 114.230195)",50
22.2809696,114.230195,16,1036,259,1295,"(22.2809696, 114.230195)",50
22.2809696,114.230195,17,228,1845,2073,"(22.2809696, 114.230195)",50
22.2809696,114.230195,18,698,1030,1728,"(22.2809696, 114.230195)",50
22.2809696,114.230195,19,687,1276,1963,"(22.2809696, 114.230195)",50
22.2809696,114.230195,20,1355,945,2300,"(22.2809696, 114.230195)",50
22.2809696,114.230195,21,632,2190,2822,"(22.2809696, 114.230195)",50
22.2809696,114.230195,22,571,1793,2364,"(22.2809696, 114.230195)",50
22.2809696,114.230195,23,0,1324,1324,"(22.2809696, 114.230195)",50
22.2504937,114.147667,0,0,380,380,"(22.2504937, 114.147667)",51
22.2504937,114.147667,1,0,196,196,"(22.2504937, 114.147667)",51
22.2504937,114.147667,2,203,185,388,"(22.2504937, 114.147667)",51
22.2504937,114.147667,3,0,0,0,"(22.2504937, 114.147667)",51
22.2504937,114.147667,4,0,0,0,"(22.2504937, 114.147667)",51
22.2504937,114.147667,5,0,0,0,"(22.2504937, 114.147667)",51
22.2504937,114.147667,6,408,188,596,"(22.2504937, 114.147667)",51
22.2504937,114.147667,7,612,210,822,"(22.2504937, 114.147667)",51
22.2504937,114.147667,8,2193,569,2762,"(22.2504937, 114.147667)",51
22.2504937,114.147667,9,203,128,331,"(22.2504937, 114.147667)",51
22.2504937,114.147667,10,0,101,101,"(22.2504937, 114.147667)",51
22.2504937,114.147667,11,201,0,201,"(22.2504937, 114.147667)",51
22.2504937,114.147667,12,195,107,302,"(22.2504937, 114.147667)",51
22.2504937,114.147667,13,841,229,1070,"(22.2504937, 114.147667)",51
22.2504937,114.147667,14,0,0,0,"(22.2504937, 114.147667)",51
22.2504937,114.147667,15,185,824,1009,"(22.2504937, 114.147667)",51
22.2504937,114.147667,16,61,0,61,"(22.2504937, 114.147667)",51
22.2504937,114.147667,17,768,1410,2178,"(22.2504937, 114.147667)",51
22.2504937,114.147667,18,444,631,1075,"(22.2504937, 114.147667)",51
22.2504937,114.147667,19,72,401,473,"(22.2504937, 114.147667)",51
22.2504937,114.147667,20,395,1708,2103,"(22.2504937, 114.147667)",51
22.2504937,114.147667,21,0,316,316,"(22.2504937, 114.147667)",51
22.2504937,114.147667,22,201,874,1075,"(22.2504937, 114.147667)",51
22.2504937,114.147667,23,0,0,0,"(22.2504937, 114.147667)",51
22.268751,114.234698,0,0,0,0,"(22.268751, 114.234698)",52
22.268751,114.234698,1,0,0,0,"(22.268751, 114.234698)",52
22.268751,114.234698,2,0,0,0,"(22.268751, 114.234698)",52
22.268751,114.234698,3,0,0,0,"(22.268751, 114.234698)",52
22.268751,114.234698,4,0,0,0,"(22.268751, 114.234698)",52
22.268751,114.234698,5,76,183,259,"(22.268751, 114.234698)",52
22.268751,114.234698,6,0,378,378,"(22.268751, 114.234698)",52
22.268751,114.234698,7,1086,828,1914,"(22.268751, 114.234698)",52
22.268751,114.234698,8,966,201,1167,"(22.268751, 114.234698)",52
22.268751,114.234698,9,1848,710,2558,"(22.268751, 114.234698)",52
22.268751,114.234698,10,1014,0,1014,"(22.268751, 114.234698)",52
22.268751,114.234698,11,0,716,716,"(22.268751, 114.234698)",52
22.268751,114.234698,12,3162,2707,5869,"(22.268751, 114.234698)",52
22.268751,114.234698,13,777,348,1125,"(22.268751, 114.234698)",52
22.268751,114.234698,14,186,0,186,"(22.268751, 114.234698)",52
22.268751,114.234698,15,986,818,1804,"(22.268751, 114.234698)",52
22.268751,114.234698,16,0,421,421,"(22.268751, 114.234698)",52
22.268751,114.234698,17,1224,1340,2564,"(22.268751, 114.234698)",52
22.268751,114.234698,18,164,463,627,"(22.268751, 114.234698)",52
22.268751,114.234698,19,809,702,1511,"(22.268751, 114.234698)",52
22.268751,114.234698,20,207,629,836,"(22.268751, 114.234698)",52
22.268751,114.234698,21,301,949,1250,"(22.268751, 114.234698)",52
22.268751,114.234698,22,0,213,213,"(22.268751, 114.234698)",52
22.268751,114.234698,23,0,242,242,"(22.268751, 114.234698)",52
22.2839821,114.1505559,0,1119,463,1582,"(22.2839821, 114.1505559)",53
22.2839821,114.1505559,1,812,288,1100,"(22.2839821, 114.1505559)",53
22.2839821,114.1505559,2,811,0,811,"(22.2839821, 114.1505559)",53
22.2839821,114.1505559,3,201,0,201,"(22.2839821, 114.1505559)",53
22.2839821,114.1505559,4,209,0,209,"(22.2839821, 114.1505559)",53
22.2839821,114.1505559,5,0,126,126,"(22.2839821, 114.1505559)",53
22.2839821,114.1505559,6,663,1107,1770,"(22.2839821, 114.1505559)",53
22.2839821,114.1505559,7,1150,6419,7569,"(22.2839821, 114.1505559)",53
22.2839821,114.1505559,8,4061,8114,12175,"(22.2839821, 114.1505559)",53
22.2839821,114.1505559,9,3205,3936,7141,"(22.2839821, 114.1505559)",53
22.2839821,114.1505559,10,2063,2185,4248,"(22.2839821, 114.1505559)",53
22.2839821,114.1505559,11,2478,3253,5731,"(22.2839821, 114.1505559)",53
22.2839821,114.1505559,12,4942,4515,9457,"(22.2839821, 114.1505559)",53
22.2839821,114.1505559,13,2968,2244,5212,"(22.2839821, 114.1505559)",53
22.2839821,114.1505559,14,1012,1058,2070,"(22.2839821, 114.1505559)",53
22.2839821,114.1505559,15,2928,1459,4387,"(22.2839821, 114.1505559)",53
22.2839821,114.1505559,16,990,2094,3084,"(22.2839821, 114.1505559)",53
22.2839821,114.1505559,17,3601,3552,7153,"(22.2839821, 114.1505559)",53
22.2839821,114.1505559,18,6720,5081,11801,"(22.2839821, 114.1505559)",53
22.2839821,114.1505559,19,9035,5157,14192,"(22.2839821, 114.1505559)",53
22.2839821,114.1505559,20,5187,1619,6806,"(22.2839821, 114.1505559)",53
22.2839821,114.1505559,21,3895,1295,5190,"(22.2839821, 114.1505559)",53
22.2839821,114.1505559,22,1184,1120,2304,"(22.2839821, 114.1505559)",53
22.2839821,114.1505559,23,1742,628,2370,"(22.2839821, 114.1505559)",53
22.2499655,114.1679145,0,94,17,111,"(22.2499655, 114.1679145)",54
22.2499655,114.1679145,1,0,196,196,"(22.2499655, 114.1679145)",54
22.2499655,114.1679145,2,381,401,782,"(22.2499655, 114.1679145)",54
22.2499655,114.1679145,3,0,0,0,"(22.2499655, 114.1679145)",54
22.2499655,114.1679145,4,0,0,0,"(22.2499655, 114.1679145)",54
22.2499655,114.1679145,5,0,0,0,"(22.2499655, 114.1679145)",54
22.2499655,114.1679145,6,201,470,671,"(22.2499655, 114.1679145)",54
22.2499655,114.1679145,7,181,210,391,"(22.2499655, 114.1679145)",54
22.2499655,114.1679145,8,410,15,425,"(22.2499655, 114.1679145)",54
22.2499655,114.1679145,9,215,386,601,"(22.2499655, 114.1679145)",54
22.2499655,114.1679145,10,17,597,614,"(22.2499655, 114.1679145)",54
22.2499655,114.1679145,11,202,201,403,"(22.2499655, 114.1679145)",54
22.2499655,114.1679145,12,372,132,504,"(22.2499655, 114.1679145)",54
22.2499655,114.1679145,13,307,8,315,"(22.2499655, 114.1679145)",54
22.2499655,114.1679145,14,0,0,0,"(22.2499655, 114.1679145)",54
22.2499655,114.1679145,15,204,26,230,"(22.2499655, 114.1679145)",54
22.2499655,114.1679145,16,44,0,44,"(22.2499655, 114.1679145)",54
22.2499655,114.1679145,17,564,836,1400,"(22.2499655, 114.1679145)",54
22.2499655,114.1679145,18,402,208,610,"(22.2499655, 114.1679145)",54
22.2499655,114.1679145,19,60,215,275,"(22.2499655, 114.1679145)",54
22.2499655,114.1679145,20,511,448,959,"(22.2499655, 114.1679145)",54
22.2499655,114.1679145,21,0,4,4,"(22.2499655, 114.1679145)",54
22.2499655,114.1679145,22,6,85,91,"(22.2499655, 114.1679145)",54
22.2499655,114.1679145,23,0,0,0,"(22.2499655, 114.1679145)",54
22.2594675,114.1326334,0,0,543,543,"(22.2594675, 114.1326334)",55
22.2594675,114.1326334,1,0,18,18,"(22.2594675, 114.1326334)",55
22.2594675,114.1326334,2,0,0,0,"(22.2594675, 114.1326334)",55
22.2594675,114.1326334,3,0,0,0,"(22.2594675, 114.1326334)",55
22.2594675,114.1326334,4,0,0,0,"(22.2594675, 114.1326334)",55
22.2594675,114.1326334,5,0,0,0,"(22.2594675, 114.1326334)",55
22.2594675,114.1326334,6,257,4,261,"(22.2594675, 114.1326334)",55
22.2594675,114.1326334,7,882,189,1071,"(22.2594675, 114.1326334)",55
22.2594675,114.1326334,8,2712,498,3210,"(22.2594675, 114.1326334)",55
22.2594675,114.1326334,9,745,201,946,"(22.2594675, 114.1326334)",55
22.2594675,114.1326334,10,49,220,269,"(22.2594675, 114.1326334)",55
22.2594675,114.1326334,11,217,0,217,"(22.2594675, 114.1326334)",55
22.2594675,114.1326334,12,793,57,850,"(22.2594675, 114.1326334)",55
22.2594675,114.1326334,13,1842,1447,3289,"(22.2594675, 114.1326334)",55
22.2594675,114.1326334,14,44,19,63,"(22.2594675, 114.1326334)",55
22.2594675,114.1326334,15,0,751,751,"(22.2594675, 114.1326334)",55
22.2594675,114.1326334,16,10,0,10,"(22.2594675, 114.1326334)",55
22.2594675,114.1326334,17,839,657,1496,"(22.2594675, 114.1326334)",55
22.2594675,114.1326334,18,810,1707,2517,"(22.2594675, 114.1326334)",55
22.2594675,114.1326334,19,51,992,1043,"(22.2594675, 114.1326334)",55
22.2594675,114.1326334,20,237,1210,1447,"(22.2594675, 114.1326334)",55
22.2594675,114.1326334,21,219,977,1196,"(22.2594675, 114.1326334)",55
22.2594675,114.1326334,22,201,717,918,"(22.2594675, 114.1326334)",55
22.2594675,114.1326334,23,0,0,0,"(22.2594675, 114.1326334)",55
22.2587586,114.1910696,0,43,230,273,"(22.2587586, 114.1910696)",56
22.2587586,114.1910696,1,141,0,141,"(22.2587586, 114.1910696)",56
22.2587586,114.1910696,2,198,0,198,"(22.2587586, 114.1910696)",56
22.2587586,114.1910696,3,0,0,0,"(22.2587586, 114.1910696)",56
22.2587586,114.1910696,4,124,694,818,"(22.2587586, 114.1910696)",56
22.2587586,114.1910696,5,0,0,0,"(22.2587586, 114.1910696)",56
22.2587586,114.1910696,6,33,406,439,"(22.2587586, 114.1910696)",56
22.2587586,114.1910696,7,1033,612,1645,"(22.2587586, 114.1910696)",56
22.2587586,114.1910696,8,2007,1416,3423,"(22.2587586, 114.1910696)",56
22.2587586,114.1910696,9,533,395,928,"(22.2587586, 114.1910696)",56
22.2587586,114.1910696,10,208,638,846,"(22.2587586, 114.1910696)",56
22.2587586,114.1910696,11,628,16,644,"(22.2587586, 114.1910696)",56
22.2587586,114.1910696,12,1571,199,1770,"(22.2587586, 114.1910696)",56
22.2587586,114.1910696,13,1166,1082,2248,"(22.2587586, 114.1910696)",56
22.2587586,114.1910696,14,596,399,995,"(22.2587586, 114.1910696)",56
22.2587586,114.1910696,15,902,232,1134,"(22.2587586, 114.1910696)",56
22.2587586,114.1910696,16,816,1334,2150,"(22.2587586, 114.1910696)",56
22.2587586,114.1910696,17,854,1049,1903,"(22.2587586, 114.1910696)",56
22.2587586,114.1910696,18,559,1747,2306,"(22.2587586, 114.1910696)",56
22.2587586,114.1910696,19,36,2378,2414,"(22.2587586, 114.1910696)",56
22.2587586,114.1910696,20,106,382,488,"(22.2587586, 114.1910696)",56
22.2587586,114.1910696,21,279,223,502,"(22.2587586, 114.1910696)",56
22.2587586,114.1910696,22,494,599,1093,"(22.2587586, 114.1910696)",56
22.2587586,114.1910696,23,760,201,961,"(22.2587586, 114.1910696)",56
22.2870855,114.1463105,0,1108,518,1626,"(22.2870855, 114.1463105)",57
22.2870855,114.1463105,1,551,380,931,"(22.2870855, 114.1463105)",57
22.2870855,114.1463105,2,811,0,811,"(22.2870855, 114.1463105)",57
22.2870855,114.1463105,3,201,0,201,"(22.2870855, 114.1463105)",57
22.2870855,114.1463105,4,209,0,209,"(22.2870855, 114.1463105)",57
22.2870855,114.1463105,5,0,126,126,"(22.2870855, 114.1463105)",57
22.2870855,114.1463105,6,623,1004,1627,"(22.2870855, 114.1463105)",57
22.2870855,114.1463105,7,1200,6269,7469,"(22.2870855, 114.1463105)",57
22.2870855,114.1463105,8,4280,8031,12311,"(22.2870855, 114.1463105)",57
22.2870855,114.1463105,9,3346,3673,7019,"(22.2870855, 114.1463105)",57
22.2870855,114.1463105,10,2017,1660,3677,"(22.2870855, 114.1463105)",57
22.2870855,114.1463105,11,2569,2770,5339,"(22.2870855, 114.1463105)",57
22.2870855,114.1463105,12,4693,4239,8932,"(22.2870855, 114.1463105)",57
22.2870855,114.1463105,13,2854,2269,5123,"(22.2870855, 114.1463105)",57
22.2870855,114.1463105,14,956,1141,2097,"(22.2870855, 114.1463105)",57
22.2870855,114.1463105,15,2874,1175,4049,"(22.2870855, 114.1463105)",57
22.2870855,114.1463105,16,837,2009,2846,"(22.2870855, 114.1463105)",57
22.2870855,114.1463105,17,3344,3895,7239,"(22.2870855, 114.1463105)",57
22.2870855,114.1463105,18,5900,5245,11145,"(22.2870855, 114.1463105)",57
22.2870855,114.1463105,19,8033,5168,13201,"(22.2870855, 114.1463105)",57
22.2870855,114.1463105,20,4487,1387,5874,"(22.2870855, 114.1463105)",57
22.2870855,114.1463105,21,3558,1302,4860,"(22.2870855, 114.1463105)",57
22.2870855,114.1463105,22,987,1023,2010,"(22.2870855, 114.1463105)",57
22.2870855,114.1463105,23,1557,628,2185,"(22.2870855, 114.1463105)",57
22.2775994,114.1594531,0,1537,831,2368,"(22.2775994, 114.1594531)",58
22.2775994,114.1594531,1,1049,350,1399,"(22.2775994, 114.1594531)",58
22.2775994,114.1594531,2,811,208,1019,"(22.2775994, 114.1594531)",58
22.2775994,114.1594531,3,201,0,201,"(22.2775994, 114.1594531)",58
22.2775994,114.1594531,4,496,0,496,"(22.2775994, 114.1594531)",58
22.2775994,114.1594531,5,0,126,126,"(22.2775994, 114.1594531)",58
22.2775994,114.1594531,6,715,948,1663,"(22.2775994, 114.1594531)",58
22.2775994,114.1594531,7,1455,7064,8519,"(22.2775994, 114.1594531)",58
22.2775994,114.1594531,8,3422,10409,13831,"(22.2775994, 114.1594531)",58
22.2775994,114.1594531,9,2318,4743,7061,"(22.2775994, 114.1594531)",58
22.2775994,114.1594531,10,3445,3823,7268,"(22.2775994, 114.1594531)",58
22.2775994,114.1594531,11,3349,3457,6806,"(22.2775994, 114.1594531)",58
22.2775994,114.1594531,12,4925,5046,9971,"(22.2775994, 114.1594531)",58
22.2775994,114.1594531,13,3547,3395,6942,"(22.2775994, 114.1594531)",58
22.2775994,114.1594531,14,959,1813,2772,"(22.2775994, 114.1594531)",58
22.2775994,114.1594531,15,3057,2452,5509,"(22.2775994, 114.1594531)",58
22.2775994,114.1594531,16,1648,2220,3868,"(22.2775994, 114.1594531)",58
22.2775994,114.1594531,17,3978,3099,7077,"(22.2775994, 114.1594531)",58
22.2775994,114.1594531,18,7689,5151,12840,"(22.2775994, 114.1594531)",58
22.2775994,114.1594531,19,10086,6550,16636,"(22.2775994, 114.1594531)",58
22.2775994,114.1594531,20,6145,2205,8350,"(22.2775994, 114.1594531)",58
22.2775994,114.1594531,21,3671,424,4095,"(22.2775994, 114.1594531)",58
22.2775994,114.1594531,22,2526,1326,3852,"(22.2775994, 114.1594531)",58
22.2775994,114.1594531,23,1805,412,2217,"(22.2775994, 114.1594531)",58
22.2680521,114.1866903,0,973,595,1568,"(22.2680521, 114.1866903)",59
22.2680521,114.1866903,1,791,382,1173,"(22.2680521, 114.1866903)",59
22.2680521,114.1866903,2,9,208,217,"(22.2680521, 114.1866903)",59
22.2680521,114.1866903,3,0,0,0,"(22.2680521, 114.1866903)",59
22.2680521,114.1866903,4,1169,1169,2338,"(22.2680521, 114.1866903)",59
22.2680521,114.1866903,5,0,0,0,"(22.2680521, 114.1866903)",59
22.2680521,114.1866903,6,319,406,725,"(22.2680521, 114.1866903)",59
22.2680521,114.1866903,7,1855,1339,3194,"(22.2680521, 114.1866903)",59
22.2680521,114.1866903,8,3664,4051,7715,"(22.2680521, 114.1866903)",59
22.2680521,114.1866903,9,1375,1929,3304,"(22.2680521, 114.1866903)",59
22.2680521,114.1866903,10,3166,4395,7561,"(22.2680521, 114.1866903)",59
22.2680521,114.1866903,11,2337,1309,3646,"(22.2680521, 114.1866903)",59
22.2680521,114.1866903,12,2452,3561,6013,"(22.2680521, 114.1866903)",59
22.2680521,114.1866903,13,4090,4183,8273,"(22.2680521, 114.1866903)",59
22.2680521,114.1866903,14,2844,1872,4716,"(22.2680521, 114.1866903)",59
22.2680521,114.1866903,15,2214,1565,3779,"(22.2680521, 114.1866903)",59
22.2680521,114.1866903,16,3299,2651,5950,"(22.2680521, 114.1866903)",59
22.2680521,114.1866903,17,3922,2442,6364,"(22.2680521, 114.1866903)",59
22.2680521,114.1866903,18,3033,4427,7460,"(22.2680521, 114.1866903)",59
22.2680521,114.1866903,19,3578,5505,9083,"(22.2680521, 114.1866903)",59
22.2680521,114.1866903,20,1725,2428,4153,"(22.2680521, 114.1866903)",59
22.2680521,114.1866903,21,1618,1246,2864,"(22.2680521, 114.1866903)",59
22.2680521,114.1866903,22,3109,798,3907,"(22.2680521, 114.1866903)",59
22.2680521,114.1866903,23,1211,615,1826,"(22.2680521, 114.1866903)",59
22.2901823,114.2102683,0,201,196,397,"(22.2901823, 114.2102683)",60
22.2901823,114.2102683,1,0,599,599,"(22.2901823, 114.2102683)",60
22.2901823,114.2102683,2,0,228,228,"(22.2901823, 114.2102683)",60
22.2901823,114.2102683,3,0,0,0,"(22.2901823, 114.2102683)",60
22.2901823,114.2102683,4,0,0,0,"(22.2901823, 114.2102683)",60
22.2901823,114.2102683,5,0,3,3,"(22.2901823, 114.2102683)",60
22.2901823,114.2102683,6,1000,0,1000,"(22.2901823, 114.2102683)",60
22.2901823,114.2102683,7,4088,527,4615,"(22.2901823, 114.2102683)",60
22.2901823,114.2102683,8,3777,2705,6482,"(22.2901823, 114.2102683)",60
22.2901823,114.2102683,9,846,978,1824,"(22.2901823, 114.2102683)",60
22.2901823,114.2102683,10,2464,205,2669,"(22.2901823, 114.2102683)",60
22.2901823,114.2102683,11,2180,2251,4431,"(22.2901823, 114.2102683)",60
22.2901823,114.2102683,12,407,846,1253,"(22.2901823, 114.2102683)",60
22.2901823,114.2102683,13,281,1776,2057,"(22.2901823, 114.2102683)",60
22.2901823,114.2102683,14,723,1056,1779,"(22.2901823, 114.2102683)",60
22.2901823,114.2102683,15,559,1443,2002,"(22.2901823, 114.2102683)",60
22.2901823,114.2102683,16,1587,1148,2735,"(22.2901823, 114.2102683)",60
22.2901823,114.2102683,17,343,1491,1834,"(22.2901823, 114.2102683)",60
22.2901823,114.2102683,18,1809,1558,3367,"(22.2901823, 114.2102683)",60
22.2901823,114.2102683,19,704,2481,3185,"(22.2901823, 114.2102683)",60
22.2901823,114.2102683,20,2075,1603,3678,"(22.2901823, 114.2102683)",60
22.2901823,114.2102683,21,1159,1361,2520,"(22.2901823, 114.2102683)",60
22.2901823,114.2102683,22,393,1396,1789,"(22.2901823, 114.2102683)",60
22.2901823,114.2102683,23,0,1204,1204,"(22.2901823, 114.2102683)",60
22.2854599,114.1346733,0,802,223,1025,"(22.2854599, 114.1346733)",61
22.2854599,114.1346733,1,403,290,693,"(22.2854599, 114.1346733)",61
22.2854599,114.1346733,2,64,0,64,"(22.2854599, 114.1346733)",61
22.2854599,114.1346733,3,40,0,40,"(22.2854599, 114.1346733)",61
22.2854599,114.1346733,4,209,0,209,"(22.2854599, 114.1346733)",61
22.2854599,114.1346733,5,0,24,24,"(22.2854599, 114.1346733)",61
22.2854599,114.1346733,6,587,606,1193,"(22.2854599, 114.1346733)",61
22.2854599,114.1346733,7,1169,1279,2448,"(22.2854599, 114.1346733)",61
22.2854599,114.1346733,8,4479,896,5375,"(22.2854599, 114.1346733)",61
22.2854599,114.1346733,9,3001,1363,4364,"(22.2854599, 114.1346733)",61
22.2854599,114.1346733,10,1855,820,2675,"(22.2854599, 114.1346733)",61
22.2854599,114.1346733,11,1678,1008,2686,"(22.2854599, 114.1346733)",61
22.2854599,114.1346733,12,3685,2758,6443,"(22.2854599, 114.1346733)",61
22.2854599,114.1346733,13,2428,1874,4302,"(22.2854599, 114.1346733)",61
22.2854599,114.1346733,14,583,634,1217,"(22.2854599, 114.1346733)",61
22.2854599,114.1346733,15,1887,803,2690,"(22.2854599, 114.1346733)",61
22.2854599,114.1346733,16,600,1378,1978,"(22.2854599, 114.1346733)",61
22.2854599,114.1346733,17,1018,3562,4580,"(22.2854599, 114.1346733)",61
22.2854599,114.1346733,18,1318,4820,6138,"(22.2854599, 114.1346733)",61
22.2854599,114.1346733,19,1729,3379,5108,"(22.2854599, 114.1346733)",61
22.2854599,114.1346733,20,1848,1048,2896,"(22.2854599, 114.1346733)",61
22.2854599,114.1346733,21,1392,1637,3029,"(22.2854599, 114.1346733)",61
22.2854599,114.1346733,22,258,709,967,"(22.2854599, 114.1346733)",61
22.2854599,114.1346733,23,906,628,1534,"(22.2854599, 114.1346733)",61
22.2755045,114.1676755,0,1439,863,2302,"(22.2755045, 114.1676755)",62
22.2755045,114.1676755,1,1023,386,1409,"(22.2755045, 114.1676755)",62
22.2755045,114.1676755,2,815,208,1023,"(22.2755045, 114.1676755)",62
22.2755045,114.1676755,3,201,0,201,"(22.2755045, 114.1676755)",62
22.2755045,114.1676755,4,1169,52,1221,"(22.2755045, 114.1676755)",62
22.2755045,114.1676755,5,0,126,126,"(22.2755045, 114.1676755)",62
22.2755045,114.1676755,6,718,726,1444,"(22.2755045, 114.1676755)",62
22.2755045,114.1676755,7,1389,6984,8373,"(22.2755045, 114.1676755)",62
22.2755045,114.1676755,8,2331,10701,13032,"(22.2755045, 114.1676755)",62
22.2755045,114.1676755,9,2345,5031,7376,"(22.2755045, 114.1676755)",62
22.2755045,114.1676755,10,2589,6393,8982,"(22.2755045, 114.1676755)",62
22.2755045,114.1676755,11,3810,4315,8125,"(22.2755045, 114.1676755)",62
22.2755045,114.1676755,12,3617,6342,9959,"(22.2755045, 114.1676755)",62
22.2755045,114.1676755,13,5499,4360,9859,"(22.2755045, 114.1676755)",62
22.2755045,114.1676755,14,2404,2382,4786,"(22.2755045, 114.1676755)",62
22.2755045,114.1676755,15,2402,2379,4781,"(22.2755045, 114.1676755)",62
22.2755045,114.1676755,16,3227,1914,5141,"(22.2755045, 114.1676755)",62
22.2755045,114.1676755,17,5729,2409,8138,"(22.2755045, 114.1676755)",62
22.2755045,114.1676755,18,8985,4635,13620,"(22.2755045, 114.1676755)",62
22.2755045,114.1676755,19,11695,6698,18393,"(22.2755045, 114.1676755)",62
22.2755045,114.1676755,20,5535,2730,8265,"(22.2755045, 114.1676755)",62
22.2755045,114.1676755,21,4259,589,4848,"(22.2755045, 114.1676755)",62
22.2755045,114.1676755,22,4064,1123,5187,"(22.2755045, 114.1676755)",62
22.2755045,114.1676755,23,2276,242,2518,"(22.2755045, 114.1676755)",62
22.2799933,114.1773972,0,1286,731,2017,"(22.2799933, 114.1773972)",63
22.2799933,114.1773972,1,1587,389,1976,"(22.2799933, 114.1773972)",63
22.2799933,114.1773972,2,425,208,633,"(22.2799933, 114.1773972)",63
22.2799933,114.1773972,3,0,0,0,"(22.2799933, 114.1773972)",63
22.2799933,114.1773972,4,1169,1169,2338,"(22.2799933, 114.1773972)",63
22.2799933,114.1773972,5,0,0,0,"(22.2799933, 114.1773972)",63
22.2799933,114.1773972,6,379,587,966,"(22.2799933, 114.1773972)",63
22.2799933,114.1773972,7,1379,3121,4500,"(22.2799933, 114.1773972)",63
22.2799933,114.1773972,8,3127,7063,10190,"(22.2799933, 114.1773972)",63
22.2799933,114.1773972,9,1346,3139,4485,"(22.2799933, 114.1773972)",63
22.2799933,114.1773972,10,3065,5743,8808,"(22.2799933, 114.1773972)",63
22.2799933,114.1773972,11,2120,3076,5196,"(22.2799933, 114.1773972)",63
22.2799933,114.1773972,12,2576,4954,7530,"(22.2799933, 114.1773972)",63
22.2799933,114.1773972,13,4465,5434,9899,"(22.2799933, 114.1773972)",63
22.2799933,114.1773972,14,2700,1954,4654,"(22.2799933, 114.1773972)",63
22.2799933,114.1773972,15,2019,2801,4820,"(22.2799933, 114.1773972)",63
22.2799933,114.1773972,16,3133,2531,5664,"(22.2799933, 114.1773972)",63
22.2799933,114.1773972,17,4629,2390,7019,"(22.2799933, 114.1773972)",63
22.2799933,114.1773972,18,5900,4699,10599,"(22.2799933, 114.1773972)",63
22.2799933,114.1773972,19,6743,5579,12322,"(22.2799933, 114.1773972)",63
22.2799933,114.1773972,20,3463,3450,6913,"(22.2799933, 114.1773972)",63
22.2799933,114.1773972,21,3558,1275,4833,"(22.2799933, 114.1773972)",63
22.2799933,114.1773972,22,3845,728,4573,"(22.2799933, 114.1773972)",63
22.2799933,114.1773972,23,2672,615,3287,"(22.2799933, 114.1773972)",63
22.2831633,114.1433684,0,1108,536,1644,"(22.2831633, 114.1433684)",64
22.2831633,114.1433684,1,476,419,895,"(22.2831633, 114.1433684)",64
22.2831633,114.1433684,2,811,0,811,"(22.2831633, 114.1433684)",64
22.2831633,114.1433684,3,201,0,201,"(22.2831633, 114.1433684)",64
22.2831633,114.1433684,4,209,0,209,"(22.2831633, 114.1433684)",64
22.2831633,114.1433684,5,0,126,126,"(22.2831633, 114.1433684)",64
22.2831633,114.1433684,6,623,1019,1642,"(22.2831633, 114.1433684)",64
22.2831633,114.1433684,7,1267,6168,7435,"(22.2831633, 114.1433684)",64
22.2831633,114.1433684,8,4417,7757,12174,"(22.2831633, 114.1433684)",64
22.2831633,114.1433684,9,3436,3630,7066,"(22.2831633, 114.1433684)",64
22.2831633,114.1433684,10,2026,1725,3751,"(22.2831633, 114.1433684)",64
22.2831633,114.1433684,11,2596,2549,5145,"(22.2831633, 114.1433684)",64
22.2831633,114.1433684,12,4844,4184,9028,"(22.2831633, 114.1433684)",64
22.2831633,114.1433684,13,3121,2631,5752,"(22.2831633, 114.1433684)",64
22.2831633,114.1433684,14,963,1174,2137,"(22.2831633, 114.1433684)",64
22.2831633,114.1433684,15,2883,979,3862,"(22.2831633, 114.1433684)",64
22.2831633,114.1433684,16,848,2009,2857,"(22.2831633, 114.1433684)",64
22.2831633,114.1433684,17,3373,4017,7390,"(22.2831633, 114.1433684)",64
22.2831633,114.1433684,18,5990,5524,11514,"(22.2831633, 114.1433684)",64
22.2831633,114.1433684,19,7857,5339,13196,"(22.2831633, 114.1433684)",64
22.2831633,114.1433684,20,4489,1287,5776,"(22.2831633, 114.1433684)",64
22.2831633,114.1433684,21,3534,1551,5085,"(22.2831633, 114.1433684)",64
22.2831633,114.1433684,22,987,1031,2018,"(22.2831633, 114.1433684)",64
22.2831633,114.1433684,23,1493,628,2121,"(22.2831633, 114.1433684)",64
22.3636057,114.2586437,0,0,0,0,"(22.3636057, 114.2586437)",65
22.3636057,114.2586437,1,0,0,0,"(22.3636057, 114.2586437)",65
22.3636057,114.2586437,2,0,0,0,"(22.3636057, 114.2586437)",65
22.3636057,114.2586437,3,0,0,0,"(22.3636057, 114.2586437)",65
22.3636057,114.2586437,4,0,0,0,"(22.3636057, 114.2586437)",65
22.3636057,114.2586437,5,0,0,0,"(22.3636057, 114.2586437)",65
22.3636057,114.2586437,6,125,0,125,"(22.3636057, 114.2586437)",65
22.3636057,114.2586437,7,0,0,0,"(22.3636057, 114.2586437)",65
22.3636057,114.2586437,8,0,0,0,"(22.3636057, 114.2586437)",65
22.3636057,114.2586437,9,297,0,297,"(22.3636057, 114.2586437)",65
22.3636057,114.2586437,10,0,0,0,"(22.3636057, 114.2586437)",65
22.3636057,114.2586437,11,0,0,0,"(22.3636057, 114.2586437)",65
22.3636057,114.2586437,12,0,0,0,"(22.3636057, 114.2586437)",65
22.3636057,114.2586437,13,0,0,0,"(22.3636057, 114.2586437)",65
22.3636057,114.2586437,14,182,138,320,"(22.3636057, 114.2586437)",65
22.3636057,114.2586437,15,0,154,154,"(22.3636057, 114.2586437)",65
22.3636057,114.2586437,16,0,0,0,"(22.3636057, 114.2586437)",65
22.3636057,114.2586437,17,0,0,0,"(22.3636057, 114.2586437)",65
22.3636057,114.2586437,18,145,282,427,"(22.3636057, 114.2586437)",65
22.3636057,114.2586437,19,0,0,0,"(22.3636057, 114.2586437)",65
22.3636057,114.2586437,20,0,0,0,"(22.3636057, 114.2586437)",65
22.3636057,114.2586437,21,0,0,0,"(22.3636057, 114.2586437)",65
22.3636057,114.2586437,22,0,0,0,"(22.3636057, 114.2586437)",65
22.3636057,114.2586437,23,0,0,0,"(22.3636057, 114.2586437)",65
22.3744282,114.1698114,0,0,260,260,"(22.3744282, 114.1698114)",66
22.3744282,114.1698114,1,186,115,301,"(22.3744282, 114.1698114)",66
22.3744282,114.1698114,2,354,119,473,"(22.3744282, 114.1698114)",66
22.3744282,114.1698114,3,0,0,0,"(22.3744282, 114.1698114)",66
22.3744282,114.1698114,4,201,0,201,"(22.3744282, 114.1698114)",66
22.3744282,114.1698114,5,0,0,0,"(22.3744282, 114.1698114)",66
22.3744282,114.1698114,6,0,0,0,"(22.3744282, 114.1698114)",66
22.3744282,114.1698114,7,216,393,609,"(22.3744282, 114.1698114)",66
22.3744282,114.1698114,8,0,205,205,"(22.3744282, 114.1698114)",66
22.3744282,114.1698114,9,160,201,361,"(22.3744282, 114.1698114)",66
22.3744282,114.1698114,10,297,0,297,"(22.3744282, 114.1698114)",66
22.3744282,114.1698114,11,598,0,598,"(22.3744282, 114.1698114)",66
22.3744282,114.1698114,12,418,102,520,"(22.3744282, 114.1698114)",66
22.3744282,114.1698114,13,165,0,165,"(22.3744282, 114.1698114)",66
22.3744282,114.1698114,14,0,792,792,"(22.3744282, 114.1698114)",66
22.3744282,114.1698114,15,143,827,970,"(22.3744282, 114.1698114)",66
22.3744282,114.1698114,16,0,411,411,"(22.3744282, 114.1698114)",66
22.3744282,114.1698114,17,0,154,154,"(22.3744282, 114.1698114)",66
22.3744282,114.1698114,18,193,1131,1324,"(22.3744282, 114.1698114)",66
22.3744282,114.1698114,19,521,247,768,"(22.3744282, 114.1698114)",66
22.3744282,114.1698114,20,0,201,201,"(22.3744282, 114.1698114)",66
22.3744282,114.1698114,21,763,265,1028,"(22.3744282, 114.1698114)",66
22.3744282,114.1698114,22,0,0,0,"(22.3744282, 114.1698114)",66
22.3744282,114.1698114,23,0,356,356,"(22.3744282, 114.1698114)",66
22.3858198,113.9800815,0,0,292,292,"(22.3858198, 113.9800815)",67
22.3858198,113.9800815,1,190,13,203,"(22.3858198, 113.9800815)",67
22.3858198,113.9800815,2,105,201,306,"(22.3858198, 113.9800815)",67
22.3858198,113.9800815,3,0,0,0,"(22.3858198, 113.9800815)",67
22.3858198,113.9800815,4,213,0,213,"(22.3858198, 113.9800815)",67
22.3858198,113.9800815,5,144,0,144,"(22.3858198, 113.9800815)",67
22.3858198,113.9800815,6,505,191,696,"(22.3858198, 113.9800815)",67
22.3858198,113.9800815,7,271,403,674,"(22.3858198, 113.9800815)",67
22.3858198,113.9800815,8,524,1205,1729,"(22.3858198, 113.9800815)",67
22.3858198,113.9800815,9,1126,612,1738,"(22.3858198, 113.9800815)",67
22.3858198,113.9800815,10,989,1207,2196,"(22.3858198, 113.9800815)",67
22.3858198,113.9800815,11,510,681,1191,"(22.3858198, 113.9800815)",67
22.3858198,113.9800815,12,403,403,806,"(22.3858198, 113.9800815)",67
22.3858198,113.9800815,13,709,962,1671,"(22.3858198, 113.9800815)",67
22.3858198,113.9800815,14,0,0,0,"(22.3858198, 113.9800815)",67
22.3858198,113.9800815,15,297,201,498,"(22.3858198, 113.9800815)",67
22.3858198,113.9800815,16,212,13,225,"(22.3858198, 113.9800815)",67
22.3858198,113.9800815,17,399,687,1086,"(22.3858198, 113.9800815)",67
22.3858198,113.9800815,18,803,1187,1990,"(22.3858198, 113.9800815)",67
22.3858198,113.9800815,19,245,20,265,"(22.3858198, 113.9800815)",67
22.3858198,113.9800815,20,549,0,549,"(22.3858198, 113.9800815)",67
22.3858198,113.9800815,21,521,11,532,"(22.3858198, 113.9800815)",67
22.3858198,113.9800815,22,338,211,549,"(22.3858198, 113.9800815)",67
22.3858198,113.9800815,23,0,0,0,"(22.3858198, 113.9800815)",67
22.3730164,114.1154115,0,0,626,626,"(22.3730164, 114.1154115)",68
22.3730164,114.1154115,1,806,364,1170,"(22.3730164, 114.1154115)",68
22.3730164,114.1154115,2,400,400,800,"(22.3730164, 114.1154115)",68
22.3730164,114.1154115,3,0,0,0,"(22.3730164, 114.1154115)",68
22.3730164,114.1154115,4,0,0,0,"(22.3730164, 114.1154115)",68
22.3730164,114.1154115,5,0,0,0,"(22.3730164, 114.1154115)",68
22.3730164,114.1154115,6,295,106,401,"(22.3730164, 114.1154115)",68
22.3730164,114.1154115,7,980,1000,1980,"(22.3730164, 114.1154115)",68
22.3730164,114.1154115,8,1567,737,2304,"(22.3730164, 114.1154115)",68
22.3730164,114.1154115,9,1060,992,2052,"(22.3730164, 114.1154115)",68
22.3730164,114.1154115,10,500,218,718,"(22.3730164, 114.1154115)",68
22.3730164,114.1154115,11,675,1366,2041,"(22.3730164, 114.1154115)",68
22.3730164,114.1154115,12,401,450,851,"(22.3730164, 114.1154115)",68
22.3730164,114.1154115,13,1511,941,2452,"(22.3730164, 114.1154115)",68
22.3730164,114.1154115,14,418,209,627,"(22.3730164, 114.1154115)",68
22.3730164,114.1154115,15,1390,983,2373,"(22.3730164, 114.1154115)",68
22.3730164,114.1154115,16,219,363,582,"(22.3730164, 114.1154115)",68
22.3730164,114.1154115,17,0,176,176,"(22.3730164, 114.1154115)",68
22.3730164,114.1154115,18,1408,505,1913,"(22.3730164, 114.1154115)",68
22.3730164,114.1154115,19,1414,783,2197,"(22.3730164, 114.1154115)",68
22.3730164,114.1154115,20,872,1211,2083,"(22.3730164, 114.1154115)",68
22.3730164,114.1154115,21,0,75,75,"(22.3730164, 114.1154115)",68
22.3730164,114.1154115,22,471,404,875,"(22.3730164, 114.1154115)",68
22.3730164,114.1154115,23,283,388,671,"(22.3730164, 114.1154115)",68
22.3813368,114.2723258,0,0,0,0,"(22.3813368, 114.2723258)",69
22.3813368,114.2723258,1,0,0,0,"(22.3813368, 114.2723258)",69
22.3813368,114.2723258,2,0,0,0,"(22.3813368, 114.2723258)",69
22.3813368,114.2723258,3,0,0,0,"(22.3813368, 114.2723258)",69
22.3813368,114.2723258,4,0,0,0,"(22.3813368, 114.2723258)",69
22.3813368,114.2723258,5,0,0,0,"(22.3813368, 114.2723258)",69
22.3813368,114.2723258,6,353,0,353,"(22.3813368, 114.2723258)",69
22.3813368,114.2723258,7,0,0,0,"(22.3813368, 114.2723258)",69
22.3813368,114.2723258,8,0,0,0,"(22.3813368, 114.2723258)",69
22.3813368,114.2723258,9,0,0,0,"(22.3813368, 114.2723258)",69
22.3813368,114.2723258,10,0,0,0,"(22.3813368, 114.2723258)",69
22.3813368,114.2723258,11,0,0,0,"(22.3813368, 114.2723258)",69
22.3813368,114.2723258,12,0,0,0,"(22.3813368, 114.2723258)",69
22.3813368,114.2723258,13,0,0,0,"(22.3813368, 114.2723258)",69
22.3813368,114.2723258,14,526,527,1053,"(22.3813368, 114.2723258)",69
22.3813368,114.2723258,15,0,0,0,"(22.3813368, 114.2723258)",69
22.3813368,114.2723258,16,0,0,0,"(22.3813368, 114.2723258)",69
22.3813368,114.2723258,17,0,208,208,"(22.3813368, 114.2723258)",69
22.3813368,114.2723258,18,0,605,605,"(22.3813368, 114.2723258)",69
22.3813368,114.2723258,19,0,0,0,"(22.3813368, 114.2723258)",69
22.3813368,114.2723258,20,0,0,0,"(22.3813368, 114.2723258)",69
22.3813368,114.2723258,21,0,0,0,"(22.3813368, 114.2723258)",69
22.3813368,114.2723258,22,0,0,0,"(22.3813368, 114.2723258)",69
22.3813368,114.2723258,23,0,0,0,"(22.3813368, 114.2723258)",69
22.3807863,114.1250299,0,0,0,0,"(22.3807863, 114.1250299)",70
22.3807863,114.1250299,1,806,0,806,"(22.3807863, 114.1250299)",70
22.3807863,114.1250299,2,400,0,400,"(22.3807863, 114.1250299)",70
22.3807863,114.1250299,3,0,0,0,"(22.3807863, 114.1250299)",70
22.3807863,114.1250299,4,0,0,0,"(22.3807863, 114.1250299)",70
22.3807863,114.1250299,5,0,0,0,"(22.3807863, 114.1250299)",70
22.3807863,114.1250299,6,0,0,0,"(22.3807863, 114.1250299)",70
22.3807863,114.1250299,7,969,598,1567,"(22.3807863, 114.1250299)",70
22.3807863,114.1250299,8,581,205,786,"(22.3807863, 114.1250299)",70
22.3807863,114.1250299,9,1409,826,2235,"(22.3807863, 114.1250299)",70
22.3807863,114.1250299,10,398,437,835,"(22.3807863, 114.1250299)",70
22.3807863,114.1250299,11,241,409,650,"(22.3807863, 114.1250299)",70
22.3807863,114.1250299,12,0,1170,1170,"(22.3807863, 114.1250299)",70
22.3807863,114.1250299,13,780,208,988,"(22.3807863, 114.1250299)",70
22.3807863,114.1250299,14,209,209,418,"(22.3807863, 114.1250299)",70
22.3807863,114.1250299,15,1032,707,1739,"(22.3807863, 114.1250299)",70
22.3807863,114.1250299,16,185,214,399,"(22.3807863, 114.1250299)",70
22.3807863,114.1250299,17,155,0,155,"(22.3807863, 114.1250299)",70
22.3807863,114.1250299,18,837,618,1455,"(22.3807863, 114.1250299)",70
22.3807863,114.1250299,19,1007,898,1905,"(22.3807863, 114.1250299)",70
22.3807863,114.1250299,20,595,808,1403,"(22.3807863, 114.1250299)",70
22.3807863,114.1250299,21,0,0,0,"(22.3807863, 114.1250299)",70
22.3807863,114.1250299,22,403,404,807,"(22.3807863, 114.1250299)",70
22.3807863,114.1250299,23,210,406,616,"(22.3807863, 114.1250299)",70
22.4449603,114.0041237,0,0,0,0,"(22.4449603, 114.0041237)",71
22.4449603,114.0041237,1,201,274,475,"(22.4449603, 114.0041237)",71
22.4449603,114.0041237,2,0,0,0,"(22.4449603, 114.0041237)",71
22.4449603,114.0041237,3,0,0,0,"(22.4449603, 114.0041237)",71
22.4449603,114.0041237,4,167,0,167,"(22.4449603, 114.0041237)",71
22.4449603,114.0041237,5,257,0,257,"(22.4449603, 114.0041237)",71
22.4449603,114.0041237,6,0,183,183,"(22.4449603, 114.0041237)",71
22.4449603,114.0041237,7,201,201,402,"(22.4449603, 114.0041237)",71
22.4449603,114.0041237,8,627,0,627,"(22.4449603, 114.0041237)",71
22.4449603,114.0041237,9,1318,909,2227,"(22.4449603, 114.0041237)",71
22.4449603,114.0041237,10,854,189,1043,"(22.4449603, 114.0041237)",71
22.4449603,114.0041237,11,706,0,706,"(22.4449603, 114.0041237)",71
22.4449603,114.0041237,12,604,0,604,"(22.4449603, 114.0041237)",71
22.4449603,114.0041237,13,0,0,0,"(22.4449603, 114.0041237)",71
22.4449603,114.0041237,14,0,0,0,"(22.4449603, 114.0041237)",71
22.4449603,114.0041237,15,402,132,534,"(22.4449603, 114.0041237)",71
22.4449603,114.0041237,16,304,402,706,"(22.4449603, 114.0041237)",71
22.4449603,114.0041237,17,114,0,114,"(22.4449603, 114.0041237)",71
22.4449603,114.0041237,18,238,0,238,"(22.4449603, 114.0041237)",71
22.4449603,114.0041237,19,7,9,16,"(22.4449603, 114.0041237)",71
22.4449603,114.0041237,20,340,1804,2144,"(22.4449603, 114.0041237)",71
22.4449603,114.0041237,21,0,250,250,"(22.4449603, 114.0041237)",71
22.4449603,114.0041237,22,0,40,40,"(22.4449603, 114.0041237)",71
22.4449603,114.0041237,23,0,404,404,"(22.4449603, 114.0041237)",71
22.3855562,113.9771206,0,0,310,310,"(22.3855562, 113.9771206)",72
22.3855562,113.9771206,1,190,141,331,"(22.3855562, 113.9771206)",72
22.3855562,113.9771206,2,105,201,306,"(22.3855562, 113.9771206)",72
22.3855562,113.9771206,3,0,0,0,"(22.3855562, 113.9771206)",72
22.3855562,113.9771206,4,213,0,213,"(22.3855562, 113.9771206)",72
22.3855562,113.9771206,5,144,0,144,"(22.3855562, 113.9771206)",72
22.3855562,113.9771206,6,512,191,703,"(22.3855562, 113.9771206)",72
22.3855562,113.9771206,7,343,403,746,"(22.3855562, 113.9771206)",72
22.3855562,113.9771206,8,643,1181,1824,"(22.3855562, 113.9771206)",72
22.3855562,113.9771206,9,1126,612,1738,"(22.3855562, 113.9771206)",72
22.3855562,113.9771206,10,1001,1207,2208,"(22.3855562, 113.9771206)",72
22.3855562,113.9771206,11,510,681,1191,"(22.3855562, 113.9771206)",72
22.3855562,113.9771206,12,403,403,806,"(22.3855562, 113.9771206)",72
22.3855562,113.9771206,13,854,1184,2038,"(22.3855562, 113.9771206)",72
22.3855562,113.9771206,14,0,0,0,"(22.3855562, 113.9771206)",72
22.3855562,113.9771206,15,297,201,498,"(22.3855562, 113.9771206)",72
22.3855562,113.9771206,16,212,154,366,"(22.3855562, 113.9771206)",72
22.3855562,113.9771206,17,399,674,1073,"(22.3855562, 113.9771206)",72
22.3855562,113.9771206,18,803,1250,2053,"(22.3855562, 113.9771206)",72
22.3855562,113.9771206,19,245,175,420,"(22.3855562, 113.9771206)",72
22.3855562,113.9771206,20,549,0,549,"(22.3855562, 113.9771206)",72
22.3855562,113.9771206,21,521,163,684,"(22.3855562, 113.9771206)",72
22.3855562,113.9771206,22,338,211,549,"(22.3855562, 113.9771206)",72
22.3855562,113.9771206,23,0,0,0,"(22.3855562, 113.9771206)",72
22.3266082,114.2656233,0,0,0,0,"(22.3266082, 114.2656233)",73
22.3266082,114.2656233,1,0,0,0,"(22.3266082, 114.2656233)",73
22.3266082,114.2656233,2,0,0,0,"(22.3266082, 114.2656233)",73
22.3266082,114.2656233,3,0,0,0,"(22.3266082, 114.2656233)",73
22.3266082,114.2656233,4,0,194,194,"(22.3266082, 114.2656233)",73
22.3266082,114.2656233,5,0,0,0,"(22.3266082, 114.2656233)",73
22.3266082,114.2656233,6,0,201,201,"(22.3266082, 114.2656233)",73
22.3266082,114.2656233,7,208,212,420,"(22.3266082, 114.2656233)",73
22.3266082,114.2656233,8,197,0,197,"(22.3266082, 114.2656233)",73
22.3266082,114.2656233,9,432,0,432,"(22.3266082, 114.2656233)",73
22.3266082,114.2656233,10,215,207,422,"(22.3266082, 114.2656233)",73
22.3266082,114.2656233,11,211,0,211,"(22.3266082, 114.2656233)",73
22.3266082,114.2656233,12,0,0,0,"(22.3266082, 114.2656233)",73
22.3266082,114.2656233,13,596,596,1192,"(22.3266082, 114.2656233)",73
22.3266082,114.2656233,14,201,395,596,"(22.3266082, 114.2656233)",73
22.3266082,114.2656233,15,183,186,369,"(22.3266082, 114.2656233)",73
22.3266082,114.2656233,16,401,0,401,"(22.3266082, 114.2656233)",73
22.3266082,114.2656233,17,213,0,213,"(22.3266082, 114.2656233)",73
22.3266082,114.2656233,18,14,97,111,"(22.3266082, 114.2656233)",73
22.3266082,114.2656233,19,0,0,0,"(22.3266082, 114.2656233)",73
22.3266082,114.2656233,20,423,512,935,"(22.3266082, 114.2656233)",73
22.3266082,114.2656233,21,0,643,643,"(22.3266082, 114.2656233)",73
22.3266082,114.2656233,22,0,202,202,"(22.3266082, 114.2656233)",73
22.3266082,114.2656233,23,0,569,569,"(22.3266082, 114.2656233)",73
22.4477695,114.1653331,0,0,0,0,"(22.4477695, 114.1653331)",74
22.4477695,114.1653331,1,269,310,579,"(22.4477695, 114.1653331)",74
22.4477695,114.1653331,2,0,169,169,"(22.4477695, 114.1653331)",74
22.4477695,114.1653331,3,0,0,0,"(22.4477695, 114.1653331)",74
22.4477695,114.1653331,4,0,0,0,"(22.4477695, 114.1653331)",74
22.4477695,114.1653331,5,0,113,113,"(22.4477695, 114.1653331)",74
22.4477695,114.1653331,6,0,0,0,"(22.4477695, 114.1653331)",74
22.4477695,114.1653331,7,1147,1146,2293,"(22.4477695, 114.1653331)",74
22.4477695,114.1653331,8,762,20,782,"(22.4477695, 114.1653331)",74
22.4477695,114.1653331,9,0,188,188,"(22.4477695, 114.1653331)",74
22.4477695,114.1653331,10,662,1002,1664,"(22.4477695, 114.1653331)",74
22.4477695,114.1653331,11,436,188,624,"(22.4477695, 114.1653331)",74
22.4477695,114.1653331,12,20,192,212,"(22.4477695, 114.1653331)",74
22.4477695,114.1653331,13,825,390,1215,"(22.4477695, 114.1653331)",74
22.4477695,114.1653331,14,2497,2030,4527,"(22.4477695, 114.1653331)",74
22.4477695,114.1653331,15,493,962,1455,"(22.4477695, 114.1653331)",74
22.4477695,114.1653331,16,472,445,917,"(22.4477695, 114.1653331)",74
22.4477695,114.1653331,17,1189,1408,2597,"(22.4477695, 114.1653331)",74
22.4477695,114.1653331,18,974,473,1447,"(22.4477695, 114.1653331)",74
22.4477695,114.1653331,19,0,0,0,"(22.4477695, 114.1653331)",74
22.4477695,114.1653331,20,1867,1345,3212,"(22.4477695, 114.1653331)",74
22.4477695,114.1653331,21,0,443,443,"(22.4477695, 114.1653331)",74
22.4477695,114.1653331,22,0,410,410,"(22.4477695, 114.1653331)",74
22.4477695,114.1653331,23,0,289,289,"(22.4477695, 114.1653331)",74
22.5068775,114.1230258,0,0,201,201,"(22.5068775, 114.1230258)",75
22.5068775,114.1230258,1,0,224,224,"(22.5068775, 114.1230258)",75
22.5068775,114.1230258,2,213,0,213,"(22.5068775, 114.1230258)",75
22.5068775,114.1230258,3,189,21,210,"(22.5068775, 114.1230258)",75
22.5068775,114.1230258,4,0,0,0,"(22.5068775, 114.1230258)",75
22.5068775,114.1230258,5,0,0,0,"(22.5068775, 114.1230258)",75
22.5068775,114.1230258,6,0,0,0,"(22.5068775, 114.1230258)",75
22.5068775,114.1230258,7,551,763,1314,"(22.5068775, 114.1230258)",75
22.5068775,114.1230258,8,71,1189,1260,"(22.5068775, 114.1230258)",75
22.5068775,114.1230258,9,0,0,0,"(22.5068775, 114.1230258)",75
22.5068775,114.1230258,10,75,411,486,"(22.5068775, 114.1230258)",75
22.5068775,114.1230258,11,168,196,364,"(22.5068775, 114.1230258)",75
22.5068775,114.1230258,12,197,536,733,"(22.5068775, 114.1230258)",75
22.5068775,114.1230258,13,241,397,638,"(22.5068775, 114.1230258)",75
22.5068775,114.1230258,14,56,31,87,"(22.5068775, 114.1230258)",75
22.5068775,114.1230258,15,201,201,402,"(22.5068775, 114.1230258)",75
22.5068775,114.1230258,16,201,52,253,"(22.5068775, 114.1230258)",75
22.5068775,114.1230258,17,220,0,220,"(22.5068775, 114.1230258)",75
22.5068775,114.1230258,18,582,38,620,"(22.5068775, 114.1230258)",75
22.5068775,114.1230258,19,6,201,207,"(22.5068775, 114.1230258)",75
22.5068775,114.1230258,20,0,32,32,"(22.5068775, 114.1230258)",75
22.5068775,114.1230258,21,391,23,414,"(22.5068775, 114.1230258)",75
22.5068775,114.1230258,22,172,1,173,"(22.5068775, 114.1230258)",75
22.5068775,114.1230258,23,0,0,0,"(22.5068775, 114.1230258)",75
22.3738871,114.190532,0,176,495,671,"(22.3738871, 114.190532)",76
22.3738871,114.190532,1,347,206,553,"(22.3738871, 114.190532)",76
22.3738871,114.190532,2,163,215,378,"(22.3738871, 114.190532)",76
22.3738871,114.190532,3,0,0,0,"(22.3738871, 114.190532)",76
22.3738871,114.190532,4,201,0,201,"(22.3738871, 114.190532)",76
22.3738871,114.190532,5,0,13,13,"(22.3738871, 114.190532)",76
22.3738871,114.190532,6,0,23,23,"(22.3738871, 114.190532)",76
22.3738871,114.190532,7,490,427,917,"(22.3738871, 114.190532)",76
22.3738871,114.190532,8,698,1001,1699,"(22.3738871, 114.190532)",76
22.3738871,114.190532,9,284,637,921,"(22.3738871, 114.190532)",76
22.3738871,114.190532,10,713,352,1065,"(22.3738871, 114.190532)",76
22.3738871,114.190532,11,840,133,973,"(22.3738871, 114.190532)",76
22.3738871,114.190532,12,1104,546,1650,"(22.3738871, 114.190532)",76
22.3738871,114.190532,13,187,0,187,"(22.3738871, 114.190532)",76
22.3738871,114.190532,14,32,1043,1075,"(22.3738871, 114.190532)",76
22.3738871,114.190532,15,857,802,1659,"(22.3738871, 114.190532)",76
22.3738871,114.190532,16,0,623,623,"(22.3738871, 114.190532)",76
22.3738871,114.190532,17,183,154,337,"(22.3738871, 114.190532)",76
22.3738871,114.190532,18,579,1778,2357,"(22.3738871, 114.190532)",76
22.3738871,114.190532,19,797,893,1690,"(22.3738871, 114.190532)",76
22.3738871,114.190532,20,123,201,324,"(22.3738871, 114.190532)",76
22.3738871,114.190532,21,1082,278,1360,"(22.3738871, 114.190532)",76
22.3738871,114.190532,22,130,397,527,"(22.3738871, 114.190532)",76
22.3738871,114.190532,23,0,342,342,"(22.3738871, 114.190532)",76
22.3579391,114.0809939,0,0,0,0,"(22.3579391, 114.0809939)",77
22.3579391,114.0809939,1,0,78,78,"(22.3579391, 114.0809939)",77
22.3579391,114.0809939,2,0,398,398,"(22.3579391, 114.0809939)",77
22.3579391,114.0809939,3,0,0,0,"(22.3579391, 114.0809939)",77
22.3579391,114.0809939,4,0,0,0,"(22.3579391, 114.0809939)",77
22.3579391,114.0809939,5,0,0,0,"(22.3579391, 114.0809939)",77
22.3579391,114.0809939,6,3,0,3,"(22.3579391, 114.0809939)",77
22.3579391,114.0809939,7,208,0,208,"(22.3579391, 114.0809939)",77
22.3579391,114.0809939,8,407,0,407,"(22.3579391, 114.0809939)",77
22.3579391,114.0809939,9,194,0,194,"(22.3579391, 114.0809939)",77
22.3579391,114.0809939,10,0,0,0,"(22.3579391, 114.0809939)",77
22.3579391,114.0809939,11,801,7,808,"(22.3579391, 114.0809939)",77
22.3579391,114.0809939,12,186,347,533,"(22.3579391, 114.0809939)",77
22.3579391,114.0809939,13,4,635,639,"(22.3579391, 114.0809939)",77
22.3579391,114.0809939,14,192,0,192,"(22.3579391, 114.0809939)",77
22.3579391,114.0809939,15,1024,205,1229,"(22.3579391, 114.0809939)",77
22.3579391,114.0809939,16,0,6,6,"(22.3579391, 114.0809939)",77
22.3579391,114.0809939,17,0,194,194,"(22.3579391, 114.0809939)",77
22.3579391,114.0809939,18,3,310,313,"(22.3579391, 114.0809939)",77
22.3579391,114.0809939,19,0,192,192,"(22.3579391, 114.0809939)",77
22.3579391,114.0809939,20,0,189,189,"(22.3579391, 114.0809939)",77
22.3579391,114.0809939,21,0,188,188,"(22.3579391, 114.0809939)",77
22.3579391,114.0809939,22,0,0,0,"(22.3579391, 114.0809939)",77
22.3579391,114.0809939,23,188,95,283,"(22.3579391, 114.0809939)",77
22.370365,114.1166178,0,0,626,626,"(22.370365, 114.1166178)",78
22.370365,114.1166178,1,806,511,1317,"(22.370365, 114.1166178)",78
22.370365,114.1166178,2,400,400,800,"(22.370365, 114.1166178)",78
22.370365,114.1166178,3,0,0,0,"(22.370365, 114.1166178)",78
22.370365,114.1166178,4,0,0,0,"(22.370365, 114.1166178)",78
22.370365,114.1166178,5,0,0,0,"(22.370365, 114.1166178)",78
22.370365,114.1166178,6,424,386,810,"(22.370365, 114.1166178)",78
22.370365,114.1166178,7,1098,999,2097,"(22.370365, 114.1166178)",78
22.370365,114.1166178,8,1938,1009,2947,"(22.370365, 114.1166178)",78
22.370365,114.1166178,9,1061,1025,2086,"(22.370365, 114.1166178)",78
22.370365,114.1166178,10,500,453,953,"(22.370365, 114.1166178)",78
22.370365,114.1166178,11,758,1384,2142,"(22.370365, 114.1166178)",78
22.370365,114.1166178,12,401,539,940,"(22.370365, 114.1166178)",78
22.370365,114.1166178,13,1652,1476,3128,"(22.370365, 114.1166178)",78
22.370365,114.1166178,14,930,208,1138,"(22.370365, 114.1166178)",78
22.370365,114.1166178,15,1425,1031,2456,"(22.370365, 114.1166178)",78
22.370365,114.1166178,16,219,466,685,"(22.370365, 114.1166178)",78
22.370365,114.1166178,17,280,179,459,"(22.370365, 114.1166178)",78
22.370365,114.1166178,18,1659,761,2420,"(22.370365, 114.1166178)",78
22.370365,114.1166178,19,1907,972,2879,"(22.370365, 114.1166178)",78
22.370365,114.1166178,20,996,1206,2202,"(22.370365, 114.1166178)",78
22.370365,114.1166178,21,201,119,320,"(22.370365, 114.1166178)",78
22.370365,114.1166178,22,604,404,1008,"(22.370365, 114.1166178)",78
22.370365,114.1166178,23,313,391,704,"(22.370365, 114.1166178)",78
22.3784632,114.266643,0,0,0,0,"(22.3784632, 114.266643)",79
22.3784632,114.266643,1,0,0,0,"(22.3784632, 114.266643)",79
22.3784632,114.266643,2,0,0,0,"(22.3784632, 114.266643)",79
22.3784632,114.266643,3,0,0,0,"(22.3784632, 114.266643)",79
22.3784632,114.266643,4,0,0,0,"(22.3784632, 114.266643)",79
22.3784632,114.266643,5,0,0,0,"(22.3784632, 114.266643)",79
22.3784632,114.266643,6,356,0,356,"(22.3784632, 114.266643)",79
22.3784632,114.266643,7,0,0,0,"(22.3784632, 114.266643)",79
22.3784632,114.266643,8,0,0,0,"(22.3784632, 114.266643)",79
22.3784632,114.266643,9,0,0,0,"(22.3784632, 114.266643)",79
22.3784632,114.266643,10,0,0,0,"(22.3784632, 114.266643)",79
22.3784632,114.266643,11,0,0,0,"(22.3784632, 114.266643)",79
22.3784632,114.266643,12,0,0,0,"(22.3784632, 114.266643)",79
22.3784632,114.266643,13,0,0,0,"(22.3784632, 114.266643)",79
22.3784632,114.266643,14,525,532,1057,"(22.3784632, 114.266643)",79
22.3784632,114.266643,15,0,2,2,"(22.3784632, 114.266643)",79
22.3784632,114.266643,16,0,0,0,"(22.3784632, 114.266643)",79
22.3784632,114.266643,17,0,208,208,"(22.3784632, 114.266643)",79
22.3784632,114.266643,18,4,617,621,"(22.3784632, 114.266643)",79
22.3784632,114.266643,19,0,0,0,"(22.3784632, 114.266643)",79
22.3784632,114.266643,20,0,0,0,"(22.3784632, 114.266643)",79
22.3784632,114.266643,21,0,0,0,"(22.3784632, 114.266643)",79
22.3784632,114.266643,22,0,0,0,"(22.3784632, 114.266643)",79
22.3784632,114.266643,23,0,0,0,"(22.3784632, 114.266643)",79
22.3777703,114.1812467,0,0,231,231,"(22.3777703, 114.1812467)",80
22.3777703,114.1812467,1,224,190,414,"(22.3777703, 114.1812467)",80
22.3777703,114.1812467,2,236,215,451,"(22.3777703, 114.1812467)",80
22.3777703,114.1812467,3,0,0,0,"(22.3777703, 114.1812467)",80
22.3777703,114.1812467,4,201,0,201,"(22.3777703, 114.1812467)",80
22.3777703,114.1812467,5,0,0,0,"(22.3777703, 114.1812467)",80
22.3777703,114.1812467,6,0,0,0,"(22.3777703, 114.1812467)",80
22.3777703,114.1812467,7,475,406,881,"(22.3777703, 114.1812467)",80
22.3777703,114.1812467,8,222,689,911,"(22.3777703, 114.1812467)",80
22.3777703,114.1812467,9,97,542,639,"(22.3777703, 114.1812467)",80
22.3777703,114.1812467,10,278,0,278,"(22.3777703, 114.1812467)",80
22.3777703,114.1812467,11,604,0,604,"(22.3777703, 114.1812467)",80
22.3777703,114.1812467,12,721,504,1225,"(22.3777703, 114.1812467)",80
22.3777703,114.1812467,13,187,0,187,"(22.3777703, 114.1812467)",80
22.3777703,114.1812467,14,0,801,801,"(22.3777703, 114.1812467)",80
22.3777703,114.1812467,15,77,749,826,"(22.3777703, 114.1812467)",80
22.3777703,114.1812467,16,0,420,420,"(22.3777703, 114.1812467)",80
22.3777703,114.1812467,17,0,154,154,"(22.3777703, 114.1812467)",80
22.3777703,114.1812467,18,220,1669,1889,"(22.3777703, 114.1812467)",80
22.3777703,114.1812467,19,583,364,947,"(22.3777703, 114.1812467)",80
22.3777703,114.1812467,20,0,201,201,"(22.3777703, 114.1812467)",80
22.3777703,114.1812467,21,1059,238,1297,"(22.3777703, 114.1812467)",80
22.3777703,114.1812467,22,0,397,397,"(22.3777703, 114.1812467)",80
22.3777703,114.1812467,23,0,339,339,"(22.3777703, 114.1812467)",80
22.3807574,114.2727273,0,0,0,0,"(22.3807574, 114.2727273)",81
22.3807574,114.2727273,1,0,0,0,"(22.3807574, 114.2727273)",81
22.3807574,114.2727273,2,0,0,0,"(22.3807574, 114.2727273)",81
22.3807574,114.2727273,3,0,0,0,"(22.3807574, 114.2727273)",81
22.3807574,114.2727273,4,0,0,0,"(22.3807574, 114.2727273)",81
22.3807574,114.2727273,5,0,0,0,"(22.3807574, 114.2727273)",81
22.3807574,114.2727273,6,353,0,353,"(22.3807574, 114.2727273)",81
22.3807574,114.2727273,7,0,0,0,"(22.3807574, 114.2727273)",81
22.3807574,114.2727273,8,0,0,0,"(22.3807574, 114.2727273)",81
22.3807574,114.2727273,9,0,0,0,"(22.3807574, 114.2727273)",81
22.3807574,114.2727273,10,0,0,0,"(22.3807574, 114.2727273)",81
22.3807574,114.2727273,11,0,0,0,"(22.3807574, 114.2727273)",81
22.3807574,114.2727273,12,0,0,0,"(22.3807574, 114.2727273)",81
22.3807574,114.2727273,13,0,0,0,"(22.3807574, 114.2727273)",81
22.3807574,114.2727273,14,526,531,1057,"(22.3807574, 114.2727273)",81
22.3807574,114.2727273,15,0,0,0,"(22.3807574, 114.2727273)",81
22.3807574,114.2727273,16,0,0,0,"(22.3807574, 114.2727273)",81
22.3807574,114.2727273,17,0,208,208,"(22.3807574, 114.2727273)",81
22.3807574,114.2727273,18,0,605,605,"(22.3807574, 114.2727273)",81
22.3807574,114.2727273,19,0,0,0,"(22.3807574, 114.2727273)",81
22.3807574,114.2727273,20,0,0,0,"(22.3807574, 114.2727273)",81
22.3807574,114.2727273,21,0,0,0,"(22.3807574, 114.2727273)",81
22.3807574,114.2727273,22,0,0,0,"(22.3807574, 114.2727273)",81
22.3807574,114.2727273,23,0,0,0,"(22.3807574, 114.2727273)",81
22.5052676,114.1275087,0,0,201,201,"(22.5052676, 114.1275087)",82
22.5052676,114.1275087,1,0,288,288,"(22.5052676, 114.1275087)",82
22.5052676,114.1275087,2,213,0,213,"(22.5052676, 114.1275087)",82
22.5052676,114.1275087,3,189,40,229,"(22.5052676, 114.1275087)",82
22.5052676,114.1275087,4,0,0,0,"(22.5052676, 114.1275087)",82
22.5052676,114.1275087,5,0,0,0,"(22.5052676, 114.1275087)",82
22.5052676,114.1275087,6,0,0,0,"(22.5052676, 114.1275087)",82
22.5052676,114.1275087,7,607,781,1388,"(22.5052676, 114.1275087)",82
22.5052676,114.1275087,8,259,1189,1448,"(22.5052676, 114.1275087)",82
22.5052676,114.1275087,9,0,0,0,"(22.5052676, 114.1275087)",82
22.5052676,114.1275087,10,165,411,576,"(22.5052676, 114.1275087)",82
22.5052676,114.1275087,11,196,196,392,"(22.5052676, 114.1275087)",82
22.5052676,114.1275087,12,272,566,838,"(22.5052676, 114.1275087)",82
22.5052676,114.1275087,13,293,395,688,"(22.5052676, 114.1275087)",82
22.5052676,114.1275087,14,179,83,262,"(22.5052676, 114.1275087)",82
22.5052676,114.1275087,15,201,201,402,"(22.5052676, 114.1275087)",82
22.5052676,114.1275087,16,201,94,295,"(22.5052676, 114.1275087)",82
22.5052676,114.1275087,17,220,0,220,"(22.5052676, 114.1275087)",82
22.5052676,114.1275087,18,623,69,692,"(22.5052676, 114.1275087)",82
22.5052676,114.1275087,19,0,201,201,"(22.5052676, 114.1275087)",82
22.5052676,114.1275087,20,0,66,66,"(22.5052676, 114.1275087)",82
22.5052676,114.1275087,21,391,25,416,"(22.5052676, 114.1275087)",82
22.5052676,114.1275087,22,172,5,177,"(22.5052676, 114.1275087)",82
22.5052676,114.1275087,23,0,0,0,"(22.5052676, 114.1275087)",82
22.3708274,114.1827948,0,0,432,432,"(22.3708274, 114.1827948)",83
22.3708274,114.1827948,1,195,191,386,"(22.3708274, 114.1827948)",83
22.3708274,114.1827948,2,379,215,594,"(22.3708274, 114.1827948)",83
22.3708274,114.1827948,3,0,0,0,"(22.3708274, 114.1827948)",83
22.3708274,114.1827948,4,201,0,201,"(22.3708274, 114.1827948)",83
22.3708274,114.1827948,5,0,1,1,"(22.3708274, 114.1827948)",83
22.3708274,114.1827948,6,0,0,0,"(22.3708274, 114.1827948)",83
22.3708274,114.1827948,7,216,409,625,"(22.3708274, 114.1827948)",83
22.3708274,114.1827948,8,9,644,653,"(22.3708274, 114.1827948)",83
22.3708274,114.1827948,9,211,543,754,"(22.3708274, 114.1827948)",83
22.3708274,114.1827948,10,595,0,595,"(22.3708274, 114.1827948)",83
22.3708274,114.1827948,11,610,1,611,"(22.3708274, 114.1827948)",83
22.3708274,114.1827948,12,660,366,1026,"(22.3708274, 114.1827948)",83
22.3708274,114.1827948,13,187,0,187,"(22.3708274, 114.1827948)",83
22.3708274,114.1827948,14,0,806,806,"(22.3708274, 114.1827948)",83
22.3708274,114.1827948,15,177,1090,1267,"(22.3708274, 114.1827948)",83
22.3708274,114.1827948,16,0,430,430,"(22.3708274, 114.1827948)",83
22.3708274,114.1827948,17,0,154,154,"(22.3708274, 114.1827948)",83
22.3708274,114.1827948,18,220,1671,1891,"(22.3708274, 114.1827948)",83
22.3708274,114.1827948,19,583,500,1083,"(22.3708274, 114.1827948)",83
22.3708274,114.1827948,20,0,203,203,"(22.3708274, 114.1827948)",83
22.3708274,114.1827948,21,977,559,1536,"(22.3708274, 114.1827948)",83
22.3708274,114.1827948,22,0,397,397,"(22.3708274, 114.1827948)",83
22.3708274,114.1827948,23,0,404,404,"(22.3708274, 114.1827948)",83
22.3663189,114.1258132,0,0,583,583,"(22.3663189, 114.1258132)",84
22.3663189,114.1258132,1,806,219,1025,"(22.3663189, 114.1258132)",84
22.3663189,114.1258132,2,400,583,983,"(22.3663189, 114.1258132)",84
22.3663189,114.1258132,3,0,0,0,"(22.3663189, 114.1258132)",84
22.3663189,114.1258132,4,0,0,0,"(22.3663189, 114.1258132)",84
22.3663189,114.1258132,5,0,0,0,"(22.3663189, 114.1258132)",84
22.3663189,114.1258132,6,731,591,1322,"(22.3663189, 114.1258132)",84
22.3663189,114.1258132,7,984,1104,2088,"(22.3663189, 114.1258132)",84
22.3663189,114.1258132,8,989,832,1821,"(22.3663189, 114.1258132)",84
22.3663189,114.1258132,9,1637,1568,3205,"(22.3663189, 114.1258132)",84
22.3663189,114.1258132,10,1464,1121,2585,"(22.3663189, 114.1258132)",84
22.3663189,114.1258132,11,466,955,1421,"(22.3663189, 114.1258132)",84
22.3663189,114.1258132,12,501,1531,2032,"(22.3663189, 114.1258132)",84
22.3663189,114.1258132,13,1255,1796,3051,"(22.3663189, 114.1258132)",84
22.3663189,114.1258132,14,1036,108,1144,"(22.3663189, 114.1258132)",84
22.3663189,114.1258132,15,1273,1188,2461,"(22.3663189, 114.1258132)",84
22.3663189,114.1258132,16,230,387,617,"(22.3663189, 114.1258132)",84
22.3663189,114.1258132,17,410,294,704,"(22.3663189, 114.1258132)",84
22.3663189,114.1258132,18,1806,784,2590,"(22.3663189, 114.1258132)",84
22.3663189,114.1258132,19,2590,1092,3682,"(22.3663189, 114.1258132)",84
22.3663189,114.1258132,20,1049,1268,2317,"(22.3663189, 114.1258132)",84
22.3663189,114.1258132,21,201,1259,1460,"(22.3663189, 114.1258132)",84
22.3663189,114.1258132,22,604,404,1008,"(22.3663189, 114.1258132)",84
22.3663189,114.1258132,23,250,490,740,"(22.3663189, 114.1258132)",84
22.448902,114.165127,0,0,0,0,"(22.448902, 114.165127)",85
22.448902,114.165127,1,268,310,578,"(22.448902, 114.165127)",85
22.448902,114.165127,2,0,169,169,"(22.448902, 114.165127)",85
22.448902,114.165127,3,0,0,0,"(22.448902, 114.165127)",85
22.448902,114.165127,4,0,0,0,"(22.448902, 114.165127)",85
22.448902,114.165127,5,0,113,113,"(22.448902, 114.165127)",85
22.448902,114.165127,6,0,0,0,"(22.448902, 114.165127)",85
22.448902,114.165127,7,1147,1146,2293,"(22.448902, 114.165127)",85
22.448902,114.165127,8,762,21,783,"(22.448902, 114.165127)",85
22.448902,114.165127,9,0,154,154,"(22.448902, 114.165127)",85
22.448902,114.165127,10,662,1005,1667,"(22.448902, 114.165127)",85
22.448902,114.165127,11,457,188,645,"(22.448902, 114.165127)",85
22.448902,114.165127,12,21,192,213,"(22.448902, 114.165127)",85
22.448902,114.165127,13,765,389,1154,"(22.448902, 114.165127)",85
22.448902,114.165127,14,2496,2038,4534,"(22.448902, 114.165127)",85
22.448902,114.165127,15,474,963,1437,"(22.448902, 114.165127)",85
22.448902,114.165127,16,470,444,914,"(22.448902, 114.165127)",85
22.448902,114.165127,17,1189,1407,2596,"(22.448902, 114.165127)",85
22.448902,114.165127,18,975,463,1438,"(22.448902, 114.165127)",85
22.448902,114.165127,19,0,0,0,"(22.448902, 114.165127)",85
22.448902,114.165127,20,1864,1345,3209,"(22.448902, 114.165127)",85
22.448902,114.165127,21,0,446,446,"(22.448902, 114.165127)",85
22.448902,114.165127,22,0,410,410,"(22.448902, 114.165127)",85
22.448902,114.165127,23,0,289,289,"(22.448902, 114.165127)",85
22.3621998,114.11944,0,0,790,790,"(22.3621998, 114.11944)",86
22.3621998,114.11944,1,806,692,1498,"(22.3621998, 114.11944)",86
22.3621998,114.11944,2,400,590,990,"(22.3621998, 114.11944)",86
22.3621998,114.11944,3,0,0,0,"(22.3621998, 114.11944)",86
22.3621998,114.11944,4,0,0,0,"(22.3621998, 114.11944)",86
22.3621998,114.11944,5,0,0,0,"(22.3621998, 114.11944)",86
22.3621998,114.11944,6,654,792,1446,"(22.3621998, 114.11944)",86
22.3621998,114.11944,7,1321,1282,2603,"(22.3621998, 114.11944)",86
22.3621998,114.11944,8,2461,1803,4264,"(22.3621998, 114.11944)",86
22.3621998,114.11944,9,893,1765,2658,"(22.3621998, 114.11944)",86
22.3621998,114.11944,10,783,985,1768,"(22.3621998, 114.11944)",86
22.3621998,114.11944,11,673,1385,2058,"(22.3621998, 114.11944)",86
22.3621998,114.11944,12,725,410,1135,"(22.3621998, 114.11944)",86
22.3621998,114.11944,13,1862,2148,4010,"(22.3621998, 114.11944)",86
22.3621998,114.11944,14,1036,73,1109,"(22.3621998, 114.11944)",86
22.3621998,114.11944,15,1415,1186,2601,"(22.3621998, 114.11944)",86
22.3621998,114.11944,16,246,700,946,"(22.3621998, 114.11944)",86
22.3621998,114.11944,17,741,317,1058,"(22.3621998, 114.11944)",86
22.3621998,114.11944,18,2008,906,2914,"(22.3621998, 114.11944)",86
22.3621998,114.11944,19,2410,1309,3719,"(22.3621998, 114.11944)",86
22.3621998,114.11944,20,1107,1244,2351,"(22.3621998, 114.11944)",86
22.3621998,114.11944,21,396,203,599,"(22.3621998, 114.11944)",86
22.3621998,114.11944,22,604,1263,1867,"(22.3621998, 114.11944)",86
22.3621998,114.11944,23,416,390,806,"(22.3621998, 114.11944)",86
22.4464205,114.1676944,0,0,0,0,"(22.4464205, 114.1676944)",87
22.4464205,114.1676944,1,255,294,549,"(22.4464205, 114.1676944)",87
22.4464205,114.1676944,2,0,160,160,"(22.4464205, 114.1676944)",87
22.4464205,114.1676944,3,0,0,0,"(22.4464205, 114.1676944)",87
22.4464205,114.1676944,4,0,0,0,"(22.4464205, 114.1676944)",87
22.4464205,114.1676944,5,0,113,113,"(22.4464205, 114.1676944)",87
22.4464205,114.1676944,6,0,0,0,"(22.4464205, 114.1676944)",87
22.4464205,114.1676944,7,1147,1147,2294,"(22.4464205, 114.1676944)",87
22.4464205,114.1676944,8,762,33,795,"(22.4464205, 114.1676944)",87
22.4464205,114.1676944,9,0,312,312,"(22.4464205, 114.1676944)",87
22.4464205,114.1676944,10,629,1004,1633,"(22.4464205, 114.1676944)",87
22.4464205,114.1676944,11,406,188,594,"(22.4464205, 114.1676944)",87
22.4464205,114.1676944,12,25,192,217,"(22.4464205, 114.1676944)",87
22.4464205,114.1676944,13,886,388,1274,"(22.4464205, 114.1676944)",87
22.4464205,114.1676944,14,2496,2036,4532,"(22.4464205, 114.1676944)",87
22.4464205,114.1676944,15,513,962,1475,"(22.4464205, 114.1676944)",87
22.4464205,114.1676944,16,451,444,895,"(22.4464205, 114.1676944)",87
22.4464205,114.1676944,17,1189,1407,2596,"(22.4464205, 114.1676944)",87
22.4464205,114.1676944,18,981,547,1528,"(22.4464205, 114.1676944)",87
22.4464205,114.1676944,19,0,0,0,"(22.4464205, 114.1676944)",87
22.4464205,114.1676944,20,1861,1308,3169,"(22.4464205, 114.1676944)",87
22.4464205,114.1676944,21,0,446,446,"(22.4464205, 114.1676944)",87
22.4464205,114.1676944,22,0,410,410,"(22.4464205, 114.1676944)",87
22.4464205,114.1676944,23,0,276,276,"(22.4464205, 114.1676944)",87
22.4015673,113.9779628,0,0,384,384,"(22.4015673, 113.9779628)",88
22.4015673,113.9779628,1,14,0,14,"(22.4015673, 113.9779628)",88
22.4015673,113.9779628,2,201,45,246,"(22.4015673, 113.9779628)",88
22.4015673,113.9779628,3,0,196,196,"(22.4015673, 113.9779628)",88
22.4015673,113.9779628,4,19,0,19,"(22.4015673, 113.9779628)",88
22.4015673,113.9779628,5,144,0,144,"(22.4015673, 113.9779628)",88
22.4015673,113.9779628,6,387,253,640,"(22.4015673, 113.9779628)",88
22.4015673,113.9779628,7,1287,973,2260,"(22.4015673, 113.9779628)",88
22.4015673,113.9779628,8,612,708,1320,"(22.4015673, 113.9779628)",88
22.4015673,113.9779628,9,908,1060,1968,"(22.4015673, 113.9779628)",88
22.4015673,113.9779628,10,104,1207,1311,"(22.4015673, 113.9779628)",88
22.4015673,113.9779628,11,604,967,1571,"(22.4015673, 113.9779628)",88
22.4015673,113.9779628,12,201,264,465,"(22.4015673, 113.9779628)",88
22.4015673,113.9779628,13,1352,388,1740,"(22.4015673, 113.9779628)",88
22.4015673,113.9779628,14,0,0,0,"(22.4015673, 113.9779628)",88
22.4015673,113.9779628,15,297,331,628,"(22.4015673, 113.9779628)",88
22.4015673,113.9779628,16,0,0,0,"(22.4015673, 113.9779628)",88
22.4015673,113.9779628,17,296,655,951,"(22.4015673, 113.9779628)",88
22.4015673,113.9779628,18,1205,1180,2385,"(22.4015673, 113.9779628)",88
22.4015673,113.9779628,19,340,70,410,"(22.4015673, 113.9779628)",88
22.4015673,113.9779628,20,549,0,549,"(22.4015673, 113.9779628)",88
22.4015673,113.9779628,21,712,304,1016,"(22.4015673, 113.9779628)",88
22.4015673,113.9779628,22,134,412,546,"(22.4015673, 113.9779628)",88
22.4015673,113.9779628,23,0,0,0,"(22.4015673, 113.9779628)",88
22.3643458,114.1365173,0,0,388,388,"(22.3643458, 114.1365173)",89
22.3643458,114.1365173,1,0,0,0,"(22.3643458, 114.1365173)",89
22.3643458,114.1365173,2,32,583,615,"(22.3643458, 114.1365173)",89
22.3643458,114.1365173,3,0,0,0,"(22.3643458, 114.1365173)",89
22.3643458,114.1365173,4,0,0,0,"(22.3643458, 114.1365173)",89
22.3643458,114.1365173,5,0,0,0,"(22.3643458, 114.1365173)",89
22.3643458,114.1365173,6,792,591,1383,"(22.3643458, 114.1365173)",89
22.3643458,114.1365173,7,944,1012,1956,"(22.3643458, 114.1365173)",89
22.3643458,114.1365173,8,483,595,1078,"(22.3643458, 114.1365173)",89
22.3643458,114.1365173,9,1607,893,2500,"(22.3643458, 114.1365173)",89
22.3643458,114.1365173,10,1416,965,2381,"(22.3643458, 114.1365173)",89
22.3643458,114.1365173,11,204,0,204,"(22.3643458, 114.1365173)",89
22.3643458,114.1365173,12,912,1614,2526,"(22.3643458, 114.1365173)",89
22.3643458,114.1365173,13,599,1434,2033,"(22.3643458, 114.1365173)",89
22.3643458,114.1365173,14,868,0,868,"(22.3643458, 114.1365173)",89
22.3643458,114.1365173,15,110,411,521,"(22.3643458, 114.1365173)",89
22.3643458,114.1365173,16,288,85,373,"(22.3643458, 114.1365173)",89
22.3643458,114.1365173,17,402,201,603,"(22.3643458, 114.1365173)",89
22.3643458,114.1365173,18,1014,697,1711,"(22.3643458, 114.1365173)",89
22.3643458,114.1365173,19,1422,992,2414,"(22.3643458, 114.1365173)",89
22.3643458,114.1365173,20,585,364,949,"(22.3643458, 114.1365173)",89
22.3643458,114.1365173,21,201,1284,1485,"(22.3643458, 114.1365173)",89
22.3643458,114.1365173,22,662,279,941,"(22.3643458, 114.1365173)",89
22.3643458,114.1365173,23,65,422,487,"(22.3643458, 114.1365173)",89
22.3728001,114.1363673,0,0,224,224,"(22.3728001, 114.1363673)",90
22.3728001,114.1363673,1,17,0,17,"(22.3728001, 114.1363673)",90
22.3728001,114.1363673,2,154,583,737,"(22.3728001, 114.1363673)",90
22.3728001,114.1363673,3,0,0,0,"(22.3728001, 114.1363673)",90
22.3728001,114.1363673,4,0,0,0,"(22.3728001, 114.1363673)",90
22.3728001,114.1363673,5,0,0,0,"(22.3728001, 114.1363673)",90
22.3728001,114.1363673,6,393,422,815,"(22.3728001, 114.1363673)",90
22.3728001,114.1363673,7,939,608,1547,"(22.3728001, 114.1363673)",90
22.3728001,114.1363673,8,568,198,766,"(22.3728001, 114.1363673)",90
22.3728001,114.1363673,9,1607,746,2353,"(22.3728001, 114.1363673)",90
22.3728001,114.1363673,10,1341,635,1976,"(22.3728001, 114.1363673)",90
22.3728001,114.1363673,11,244,9,253,"(22.3728001, 114.1363673)",90
22.3728001,114.1363673,12,396,1568,1964,"(22.3728001, 114.1363673)",90
22.3728001,114.1363673,13,398,835,1233,"(22.3728001, 114.1363673)",90
22.3728001,114.1363673,14,788,0,788,"(22.3728001, 114.1363673)",90
22.3728001,114.1363673,15,576,238,814,"(22.3728001, 114.1363673)",90
22.3728001,114.1363673,16,219,0,219,"(22.3728001, 114.1363673)",90
22.3728001,114.1363673,17,402,201,603,"(22.3728001, 114.1363673)",90
22.3728001,114.1363673,18,963,651,1614,"(22.3728001, 114.1363673)",90
22.3728001,114.1363673,19,1498,992,2490,"(22.3728001, 114.1363673)",90
22.3728001,114.1363673,20,585,29,614,"(22.3728001, 114.1363673)",90
22.3728001,114.1363673,21,201,1198,1399,"(22.3728001, 114.1363673)",90
22.3728001,114.1363673,22,604,390,994,"(22.3728001, 114.1363673)",90
22.3728001,114.1363673,23,183,422,605,"(22.3728001, 114.1363673)",90
22.360883,114.1499087,0,110,0,110,"(22.360883, 114.1499087)",91
22.360883,114.1499087,1,0,0,0,"(22.360883, 114.1499087)",91
22.360883,114.1499087,2,183,183,366,"(22.360883, 114.1499087)",91
22.360883,114.1499087,3,0,0,0,"(22.360883, 114.1499087)",91
22.360883,114.1499087,4,0,0,0,"(22.360883, 114.1499087)",91
22.360883,114.1499087,5,104,0,104,"(22.360883, 114.1499087)",91
22.360883,114.1499087,6,579,183,762,"(22.360883, 114.1499087)",91
22.360883,114.1499087,7,196,236,432,"(22.360883, 114.1499087)",91
22.360883,114.1499087,8,121,641,762,"(22.360883, 114.1499087)",91
22.360883,114.1499087,9,243,972,1215,"(22.360883, 114.1499087)",91
22.360883,114.1499087,10,982,425,1407,"(22.360883, 114.1499087)",91
22.360883,114.1499087,11,101,34,135,"(22.360883, 114.1499087)",91
22.360883,114.1499087,12,727,787,1514,"(22.360883, 114.1499087)",91
22.360883,114.1499087,13,361,348,709,"(22.360883, 114.1499087)",91
22.360883,114.1499087,14,392,0,392,"(22.360883, 114.1499087)",91
22.360883,114.1499087,15,239,341,580,"(22.360883, 114.1499087)",91
22.360883,114.1499087,16,0,0,0,"(22.360883, 114.1499087)",91
22.360883,114.1499087,17,520,201,721,"(22.360883, 114.1499087)",91
22.360883,114.1499087,18,693,483,1176,"(22.360883, 114.1499087)",91
22.360883,114.1499087,19,1014,409,1423,"(22.360883, 114.1499087)",91
22.360883,114.1499087,20,329,201,530,"(22.360883, 114.1499087)",91
22.360883,114.1499087,21,201,1290,1491,"(22.360883, 114.1499087)",91
22.360883,114.1499087,22,54,66,120,"(22.360883, 114.1499087)",91
22.360883,114.1499087,23,0,196,196,"(22.360883, 114.1499087)",91
22.4493556,114.1635072,0,0,0,0,"(22.4493556, 114.1635072)",92
22.4493556,114.1635072,1,290,329,619,"(22.4493556, 114.1635072)",92
22.4493556,114.1635072,2,0,182,182,"(22.4493556, 114.1635072)",92
22.4493556,114.1635072,3,0,0,0,"(22.4493556, 114.1635072)",92
22.4493556,114.1635072,4,0,0,0,"(22.4493556, 114.1635072)",92
22.4493556,114.1635072,5,0,113,113,"(22.4493556, 114.1635072)",92
22.4493556,114.1635072,6,0,0,0,"(22.4493556, 114.1635072)",92
22.4493556,114.1635072,7,1147,1144,2291,"(22.4493556, 114.1635072)",92
22.4493556,114.1635072,8,762,11,773,"(22.4493556, 114.1635072)",92
22.4493556,114.1635072,9,0,106,106,"(22.4493556, 114.1635072)",92
22.4493556,114.1635072,10,735,999,1734,"(22.4493556, 114.1635072)",92
22.4493556,114.1635072,11,478,188,666,"(22.4493556, 114.1635072)",92
22.4493556,114.1635072,12,11,192,203,"(22.4493556, 114.1635072)",92
22.4493556,114.1635072,13,706,390,1096,"(22.4493556, 114.1635072)",92
22.4493556,114.1635072,14,2497,2021,4518,"(22.4493556, 114.1635072)",92
22.4493556,114.1635072,15,442,961,1403,"(22.4493556, 114.1635072)",92
22.4493556,114.1635072,16,499,445,944,"(22.4493556, 114.1635072)",92
22.4493556,114.1635072,17,1189,1408,2597,"(22.4493556, 114.1635072)",92
22.4493556,114.1635072,18,965,442,1407,"(22.4493556, 114.1635072)",92
22.4493556,114.1635072,19,0,0,0,"(22.4493556, 114.1635072)",92
22.4493556,114.1635072,20,1874,1409,3283,"(22.4493556, 114.1635072)",92
22.4493556,114.1635072,21,0,442,442,"(22.4493556, 114.1635072)",92
22.4493556,114.1635072,22,0,410,410,"(22.4493556, 114.1635072)",92
22.4493556,114.1635072,23,0,297,297,"(22.4493556, 114.1635072)",92
22.5053462,114.1215687,0,0,201,201,"(22.5053462, 114.1215687)",93
22.5053462,114.1215687,1,0,237,237,"(22.5053462, 114.1215687)",93
22.5053462,114.1215687,2,213,0,213,"(22.5053462, 114.1215687)",93
22.5053462,114.1215687,3,189,15,204,"(22.5053462, 114.1215687)",93
22.5053462,114.1215687,4,0,0,0,"(22.5053462, 114.1215687)",93
22.5053462,114.1215687,5,0,0,0,"(22.5053462, 114.1215687)",93
22.5053462,114.1215687,6,0,0,0,"(22.5053462, 114.1215687)",93
22.5053462,114.1215687,7,578,766,1344,"(22.5053462, 114.1215687)",93
22.5053462,114.1215687,8,107,1189,1296,"(22.5053462, 114.1215687)",93
22.5053462,114.1215687,9,0,0,0,"(22.5053462, 114.1215687)",93
22.5053462,114.1215687,10,66,411,477,"(22.5053462, 114.1215687)",93
22.5053462,114.1215687,11,196,196,392,"(22.5053462, 114.1215687)",93
22.5053462,114.1215687,12,224,559,783,"(22.5053462, 114.1215687)",93
22.5053462,114.1215687,13,221,397,618,"(22.5053462, 114.1215687)",93
22.5053462,114.1215687,14,95,45,140,"(22.5053462, 114.1215687)",93
22.5053462,114.1215687,15,201,201,402,"(22.5053462, 114.1215687)",93
22.5053462,114.1215687,16,201,40,241,"(22.5053462, 114.1215687)",93
22.5053462,114.1215687,17,220,0,220,"(22.5053462, 114.1215687)",93
22.5053462,114.1215687,18,623,46,669,"(22.5053462, 114.1215687)",93
22.5053462,114.1215687,19,65,201,266,"(22.5053462, 114.1215687)",93
22.5053462,114.1215687,20,0,41,41,"(22.5053462, 114.1215687)",93
22.5053462,114.1215687,21,391,14,405,"(22.5053462, 114.1215687)",93
22.5053462,114.1215687,22,172,1,173,"(22.5053462, 114.1215687)",93
22.5053462,114.1215687,23,0,0,0,"(22.5053462, 114.1215687)",93
22.367637,114.136587,0,0,251,251,"(22.367637, 114.136587)",94
22.367637,114.136587,1,0,0,0,"(22.367637, 114.136587)",94
22.367637,114.136587,2,148,583,731,"(22.367637, 114.136587)",94
22.367637,114.136587,3,0,0,0,"(22.367637, 114.136587)",94
22.367637,114.136587,4,0,0,0,"(22.367637, 114.136587)",94
22.367637,114.136587,5,0,0,0,"(22.367637, 114.136587)",94
22.367637,114.136587,6,693,591,1284,"(22.367637, 114.136587)",94
22.367637,114.136587,7,761,809,1570,"(22.367637, 114.136587)",94
22.367637,114.136587,8,470,190,660,"(22.367637, 114.136587)",94
22.367637,114.136587,9,1607,806,2413,"(22.367637, 114.136587)",94
22.367637,114.136587,10,1417,665,2082,"(22.367637, 114.136587)",94
22.367637,114.136587,11,228,1,229,"(22.367637, 114.136587)",94
22.367637,114.136587,12,560,1618,2178,"(22.367637, 114.136587)",94
22.367637,114.136587,13,398,1479,1877,"(22.367637, 114.136587)",94
22.367637,114.136587,14,827,0,827,"(22.367637, 114.136587)",94
22.367637,114.136587,15,386,253,639,"(22.367637, 114.136587)",94
22.367637,114.136587,16,219,5,224,"(22.367637, 114.136587)",94
22.367637,114.136587,17,402,201,603,"(22.367637, 114.136587)",94
22.367637,114.136587,18,956,651,1607,"(22.367637, 114.136587)",94
22.367637,114.136587,19,1527,992,2519,"(22.367637, 114.136587)",94
22.367637,114.136587,20,585,36,621,"(22.367637, 114.136587)",94
22.367637,114.136587,21,201,1198,1399,"(22.367637, 114.136587)",94
22.367637,114.136587,22,604,347,951,"(22.367637, 114.136587)",94
22.367637,114.136587,23,127,422,549,"(22.367637, 114.136587)",94
22.441901,114.175109,0,0,0,0,"(22.441901, 114.175109)",95
22.441901,114.175109,1,226,232,458,"(22.441901, 114.175109)",95
22.441901,114.175109,2,0,129,129,"(22.441901, 114.175109)",95
22.441901,114.175109,3,0,0,0,"(22.441901, 114.175109)",95
22.441901,114.175109,4,0,201,201,"(22.441901, 114.175109)",95
22.441901,114.175109,5,0,113,113,"(22.441901, 114.175109)",95
22.441901,114.175109,6,0,0,0,"(22.441901, 114.175109)",95
22.441901,114.175109,7,1154,1147,2301,"(22.441901, 114.175109)",95
22.441901,114.175109,8,762,149,911,"(22.441901, 114.175109)",95
22.441901,114.175109,9,0,406,406,"(22.441901, 114.175109)",95
22.441901,114.175109,10,566,995,1561,"(22.441901, 114.175109)",95
22.441901,114.175109,11,378,188,566,"(22.441901, 114.175109)",95
22.441901,114.175109,12,36,192,228,"(22.441901, 114.175109)",95
22.441901,114.175109,13,956,350,1306,"(22.441901, 114.175109)",95
22.441901,114.175109,14,2486,2025,4511,"(22.441901, 114.175109)",95
22.441901,114.175109,15,547,972,1519,"(22.441901, 114.175109)",95
22.441901,114.175109,16,431,414,845,"(22.441901, 114.175109)",95
22.441901,114.175109,17,1189,1381,2570,"(22.441901, 114.175109)",95
22.441901,114.175109,18,996,623,1619,"(22.441901, 114.175109)",95
22.441901,114.175109,19,0,0,0,"(22.441901, 114.175109)",95
22.441901,114.175109,20,1821,1060,2881,"(22.441901, 114.175109)",95
22.441901,114.175109,21,0,441,441,"(22.441901, 114.175109)",95
22.441901,114.175109,22,0,410,410,"(22.441901, 114.175109)",95
22.441901,114.175109,23,0,251,251,"(22.441901, 114.175109)",95
22.3809853,113.9773886,0,0,208,208,"(22.3809853, 113.9773886)",96
22.3809853,113.9773886,1,190,142,332,"(22.3809853, 113.9773886)",96
22.3809853,113.9773886,2,0,201,201,"(22.3809853, 113.9773886)",96
22.3809853,113.9773886,3,0,0,0,"(22.3809853, 113.9773886)",96
22.3809853,113.9773886,4,213,0,213,"(22.3809853, 113.9773886)",96
22.3809853,113.9773886,5,129,0,129,"(22.3809853, 113.9773886)",96
22.3809853,113.9773886,6,415,191,606,"(22.3809853, 113.9773886)",96
22.3809853,113.9773886,7,161,403,564,"(22.3809853, 113.9773886)",96
22.3809853,113.9773886,8,690,1216,1906,"(22.3809853, 113.9773886)",96
22.3809853,113.9773886,9,1091,612,1703,"(22.3809853, 113.9773886)",96
22.3809853,113.9773886,10,1001,1197,2198,"(22.3809853, 113.9773886)",96
22.3809853,113.9773886,11,379,672,1051,"(22.3809853, 113.9773886)",96
22.3809853,113.9773886,12,403,403,806,"(22.3809853, 113.9773886)",96
22.3809853,113.9773886,13,817,1200,2017,"(22.3809853, 113.9773886)",96
22.3809853,113.9773886,14,0,0,0,"(22.3809853, 113.9773886)",96
22.3809853,113.9773886,15,269,201,470,"(22.3809853, 113.9773886)",96
22.3809853,113.9773886,16,212,169,381,"(22.3809853, 113.9773886)",96
22.3809853,113.9773886,17,399,599,998,"(22.3809853, 113.9773886)",96
22.3809853,113.9773886,18,747,784,1531,"(22.3809853, 113.9773886)",96
22.3809853,113.9773886,19,115,183,298,"(22.3809853, 113.9773886)",96
22.3809853,113.9773886,20,539,0,539,"(22.3809853, 113.9773886)",96
22.3809853,113.9773886,21,501,176,677,"(22.3809853, 113.9773886)",96
22.3809853,113.9773886,22,319,211,530,"(22.3809853, 113.9773886)",96
22.3809853,113.9773886,23,0,0,0,"(22.3809853, 113.9773886)",96
22.4416863,114.1774687,0,0,0,0,"(22.4416863, 114.1774687)",97
22.4416863,114.1774687,1,146,158,304,"(22.4416863, 114.1774687)",97
22.4416863,114.1774687,2,0,91,91,"(22.4416863, 114.1774687)",97
22.4416863,114.1774687,3,0,0,0,"(22.4416863, 114.1774687)",97
22.4416863,114.1774687,4,0,201,201,"(22.4416863, 114.1774687)",97
22.4416863,114.1774687,5,0,113,113,"(22.4416863, 114.1774687)",97
22.4416863,114.1774687,6,0,0,0,"(22.4416863, 114.1774687)",97
22.4416863,114.1774687,7,1153,1147,2300,"(22.4416863, 114.1774687)",97
22.4416863,114.1774687,8,761,263,1024,"(22.4416863, 114.1774687)",97
22.4416863,114.1774687,9,0,406,406,"(22.4416863, 114.1774687)",97
22.4416863,114.1774687,10,366,995,1361,"(22.4416863, 114.1774687)",97
22.4416863,114.1774687,11,375,188,563,"(22.4416863, 114.1774687)",97
22.4416863,114.1774687,12,51,192,243,"(22.4416863, 114.1774687)",97
22.4416863,114.1774687,13,777,334,1111,"(22.4416863, 114.1774687)",97
22.4416863,114.1774687,14,2481,2026,4507,"(22.4416863, 114.1774687)",97
22.4416863,114.1774687,15,547,972,1519,"(22.4416863, 114.1774687)",97
22.4416863,114.1774687,16,381,395,776,"(22.4416863, 114.1774687)",97
22.4416863,114.1774687,17,1189,1370,2559,"(22.4416863, 114.1774687)",97
22.4416863,114.1774687,18,1032,701,1733,"(22.4416863, 114.1774687)",97
22.4416863,114.1774687,19,0,0,0,"(22.4416863, 114.1774687)",97
22.4416863,114.1774687,20,1799,829,2628,"(22.4416863, 114.1774687)",97
22.4416863,114.1774687,21,0,441,441,"(22.4416863, 114.1774687)",97
22.4416863,114.1774687,22,0,410,410,"(22.4416863, 114.1774687)",97
22.4416863,114.1774687,23,0,213,213,"(22.4416863, 114.1774687)",97
22.2389208,113.9892315,0,0,0,0,"(22.2389208, 113.9892315)",98
22.2389208,113.9892315,1,0,0,0,"(22.2389208, 113.9892315)",98
22.2389208,113.9892315,2,0,0,0,"(22.2389208, 113.9892315)",98
22.2389208,113.9892315,3,0,0,0,"(22.2389208, 113.9892315)",98
22.2389208,113.9892315,4,0,0,0,"(22.2389208, 113.9892315)",98
22.2389208,113.9892315,5,0,0,0,"(22.2389208, 113.9892315)",98
22.2389208,113.9892315,6,0,0,0,"(22.2389208, 113.9892315)",98
22.2389208,113.9892315,7,0,0,0,"(22.2389208, 113.9892315)",98
22.2389208,113.9892315,8,0,0,0,"(22.2389208, 113.9892315)",98
22.2389208,113.9892315,9,0,0,0,"(22.2389208, 113.9892315)",98
22.2389208,113.9892315,10,0,30,30,"(22.2389208, 113.9892315)",98
22.2389208,113.9892315,11,0,0,0,"(22.2389208, 113.9892315)",98
22.2389208,113.9892315,12,0,0,0,"(22.2389208, 113.9892315)",98
22.2389208,113.9892315,13,0,0,0,"(22.2389208, 113.9892315)",98
22.2389208,113.9892315,14,0,0,0,"(22.2389208, 113.9892315)",98
22.2389208,113.9892315,15,0,0,0,"(22.2389208, 113.9892315)",98
22.2389208,113.9892315,16,0,0,0,"(22.2389208, 113.9892315)",98
22.2389208,113.9892315,17,46,0,46,"(22.2389208, 113.9892315)",98
22.2389208,113.9892315,18,0,0,0,"(22.2389208, 113.9892315)",98
22.2389208,113.9892315,19,0,0,0,"(22.2389208, 113.9892315)",98
22.2389208,113.9892315,20,0,0,0,"(22.2389208, 113.9892315)",98
22.2389208,113.9892315,21,0,0,0,"(22.2389208, 113.9892315)",98
22.2389208,113.9892315,22,0,0,0,"(22.2389208, 113.9892315)",98
22.2389208,113.9892315,23,0,0,0,"(22.2389208, 113.9892315)",98
22.5045053,114.1223443,0,0,201,201,"(22.5045053, 114.1223443)",99
22.5045053,114.1223443,1,0,269,269,"(22.5045053, 114.1223443)",99
22.5045053,114.1223443,2,213,0,213,"(22.5045053, 114.1223443)",99
22.5045053,114.1223443,3,189,23,212,"(22.5045053, 114.1223443)",99
22.5045053,114.1223443,4,0,0,0,"(22.5045053, 114.1223443)",99
22.5045053,114.1223443,5,0,0,0,"(22.5045053, 114.1223443)",99
22.5045053,114.1223443,6,0,0,0,"(22.5045053, 114.1223443)",99
22.5045053,114.1223443,7,592,776,1368,"(22.5045053, 114.1223443)",99
22.5045053,114.1223443,8,181,1189,1370,"(22.5045053, 114.1223443)",99
22.5045053,114.1223443,9,0,0,0,"(22.5045053, 114.1223443)",99
22.5045053,114.1223443,10,114,411,525,"(22.5045053, 114.1223443)",99
22.5045053,114.1223443,11,196,196,392,"(22.5045053, 114.1223443)",99
22.5045053,114.1223443,12,250,568,818,"(22.5045053, 114.1223443)",99
22.5045053,114.1223443,13,251,397,648,"(22.5045053, 114.1223443)",99
22.5045053,114.1223443,14,133,64,197,"(22.5045053, 114.1223443)",99
22.5045053,114.1223443,15,201,201,402,"(22.5045053, 114.1223443)",99
22.5045053,114.1223443,16,201,53,254,"(22.5045053, 114.1223443)",99
22.5045053,114.1223443,17,220,0,220,"(22.5045053, 114.1223443)",99
22.5045053,114.1223443,18,623,64,687,"(22.5045053, 114.1223443)",99
22.5045053,114.1223443,19,58,201,259,"(22.5045053, 114.1223443)",99
22.5045053,114.1223443,20,0,57,57,"(22.5045053, 114.1223443)",99
22.5045053,114.1223443,21,391,23,414,"(22.5045053, 114.1223443)",99
22.5045053,114.1223443,22,172,3,175,"(22.5045053, 114.1223443)",99
22.5045053,114.1223443,23,0,0,0,"(22.5045053, 114.1223443)",99
22.3703007,114.1150993,0,0,626,626,"(22.3703007, 114.1150993)",100
22.3703007,114.1150993,1,806,603,1409,"(22.3703007, 114.1150993)",100
22.3703007,114.1150993,2,400,400,800,"(22.3703007, 114.1150993)",100
22.3703007,114.1150993,3,0,0,0,"(22.3703007, 114.1150993)",100
22.3703007,114.1150993,4,0,0,0,"(22.3703007, 114.1150993)",100
22.3703007,114.1150993,5,0,0,0,"(22.3703007, 114.1150993)",100
22.3703007,114.1150993,6,424,293,717,"(22.3703007, 114.1150993)",100
22.3703007,114.1150993,7,1200,999,2199,"(22.3703007, 114.1150993)",100
22.3703007,114.1150993,8,2169,1173,3342,"(22.3703007, 114.1150993)",100
22.3703007,114.1150993,9,1036,1023,2059,"(22.3703007, 114.1150993)",100
22.3703007,114.1150993,10,493,218,711,"(22.3703007, 114.1150993)",100
22.3703007,114.1150993,11,748,1409,2157,"(22.3703007, 114.1150993)",100
22.3703007,114.1150993,12,401,465,866,"(22.3703007, 114.1150993)",100
22.3703007,114.1150993,13,1663,1365,3028,"(22.3703007, 114.1150993)",100
22.3703007,114.1150993,14,774,208,982,"(22.3703007, 114.1150993)",100
22.3703007,114.1150993,15,1425,1032,2457,"(22.3703007, 114.1150993)",100
22.3703007,114.1150993,16,219,520,739,"(22.3703007, 114.1150993)",100
22.3703007,114.1150993,17,6,185,191,"(22.3703007, 114.1150993)",100
22.3703007,114.1150993,18,1453,667,2120,"(22.3703007, 114.1150993)",100
22.3703007,114.1150993,19,1815,796,2611,"(22.3703007, 114.1150993)",100
22.3703007,114.1150993,20,996,1206,2202,"(22.3703007, 114.1150993)",100
22.3703007,114.1150993,21,0,164,164,"(22.3703007, 114.1150993)",100
22.3703007,114.1150993,22,604,407,1011,"(22.3703007, 114.1150993)",100
22.3703007,114.1150993,23,340,399,739,"(22.3703007, 114.1150993)",100
22.3806727,114.1806923,0,176,313,489,"(22.3806727, 114.1806923)",101
22.3806727,114.1806923,1,252,182,434,"(22.3806727, 114.1806923)",101
22.3806727,114.1806923,2,170,209,379,"(22.3806727, 114.1806923)",101
22.3806727,114.1806923,3,0,0,0,"(22.3806727, 114.1806923)",101
22.3806727,114.1806923,4,201,0,201,"(22.3806727, 114.1806923)",101
22.3806727,114.1806923,5,0,0,0,"(22.3806727, 114.1806923)",101
22.3806727,114.1806923,6,0,0,0,"(22.3806727, 114.1806923)",101
22.3806727,114.1806923,7,477,350,827,"(22.3806727, 114.1806923)",101
22.3806727,114.1806923,8,262,753,1015,"(22.3806727, 114.1806923)",101
22.3806727,114.1806923,9,13,433,446,"(22.3806727, 114.1806923)",101
22.3806727,114.1806923,10,354,80,434,"(22.3806727, 114.1806923)",101
22.3806727,114.1806923,11,565,43,608,"(22.3806727, 114.1806923)",101
22.3806727,114.1806923,12,695,506,1201,"(22.3806727, 114.1806923)",101
22.3806727,114.1806923,13,187,0,187,"(22.3806727, 114.1806923)",101
22.3806727,114.1806923,14,0,774,774,"(22.3806727, 114.1806923)",101
22.3806727,114.1806923,15,64,527,591,"(22.3806727, 114.1806923)",101
22.3806727,114.1806923,16,0,368,368,"(22.3806727, 114.1806923)",101
22.3806727,114.1806923,17,0,154,154,"(22.3806727, 114.1806923)",101
22.3806727,114.1806923,18,232,1592,1824,"(22.3806727, 114.1806923)",101
22.3806727,114.1806923,19,593,336,929,"(22.3806727, 114.1806923)",101
22.3806727,114.1806923,20,7,201,208,"(22.3806727, 114.1806923)",101
22.3806727,114.1806923,21,1059,173,1232,"(22.3806727, 114.1806923)",101
22.3806727,114.1806923,22,0,302,302,"(22.3806727, 114.1806923)",101
22.3806727,114.1806923,23,0,340,340,"(22.3806727, 114.1806923)",101
22.2968132,114.2739596,0,0,0,0,"(22.2968132, 114.2739596)",102
22.2968132,114.2739596,1,0,0,0,"(22.2968132, 114.2739596)",102
22.2968132,114.2739596,2,0,0,0,"(22.2968132, 114.2739596)",102
22.2968132,114.2739596,3,0,0,0,"(22.2968132, 114.2739596)",102
22.2968132,114.2739596,4,0,72,72,"(22.2968132, 114.2739596)",102
22.2968132,114.2739596,5,0,0,0,"(22.2968132, 114.2739596)",102
22.2968132,114.2739596,6,0,17,17,"(22.2968132, 114.2739596)",102
22.2968132,114.2739596,7,16,0,16,"(22.2968132, 114.2739596)",102
22.2968132,114.2739596,8,38,0,38,"(22.2968132, 114.2739596)",102
22.2968132,114.2739596,9,244,188,432,"(22.2968132, 114.2739596)",102
22.2968132,114.2739596,10,40,1,41,"(22.2968132, 114.2739596)",102
22.2968132,114.2739596,11,163,0,163,"(22.2968132, 114.2739596)",102
22.2968132,114.2739596,12,0,0,0,"(22.2968132, 114.2739596)",102
22.2968132,114.2739596,13,259,47,306,"(22.2968132, 114.2739596)",102
22.2968132,114.2739596,14,0,201,201,"(22.2968132, 114.2739596)",102
22.2968132,114.2739596,15,289,0,289,"(22.2968132, 114.2739596)",102
22.2968132,114.2739596,16,44,0,44,"(22.2968132, 114.2739596)",102
22.2968132,114.2739596,17,0,0,0,"(22.2968132, 114.2739596)",102
22.2968132,114.2739596,18,0,201,201,"(22.2968132, 114.2739596)",102
22.2968132,114.2739596,19,109,134,243,"(22.2968132, 114.2739596)",102
22.2968132,114.2739596,20,149,27,176,"(22.2968132, 114.2739596)",102
22.2968132,114.2739596,21,0,80,80,"(22.2968132, 114.2739596)",102
22.2968132,114.2739596,22,0,39,39,"(22.2968132, 114.2739596)",102
22.2968132,114.2739596,23,0,391,391,"(22.2968132, 114.2739596)",102
22.4599724,114.2009744,0,0,0,0,"(22.4599724, 114.2009744)",103
22.4599724,114.2009744,1,0,0,0,"(22.4599724, 114.2009744)",103
22.4599724,114.2009744,2,106,0,106,"(22.4599724, 114.2009744)",103
22.4599724,114.2009744,3,0,0,0,"(22.4599724, 114.2009744)",103
22.4599724,114.2009744,4,0,201,201,"(22.4599724, 114.2009744)",103
22.4599724,114.2009744,5,0,0,0,"(22.4599724, 114.2009744)",103
22.4599724,114.2009744,6,0,0,0,"(22.4599724, 114.2009744)",103
22.4599724,114.2009744,7,0,0,0,"(22.4599724, 114.2009744)",103
22.4599724,114.2009744,8,0,749,749,"(22.4599724, 114.2009744)",103
22.4599724,114.2009744,9,87,0,87,"(22.4599724, 114.2009744)",103
22.4599724,114.2009744,10,0,0,0,"(22.4599724, 114.2009744)",103
22.4599724,114.2009744,11,0,0,0,"(22.4599724, 114.2009744)",103
22.4599724,114.2009744,12,180,0,180,"(22.4599724, 114.2009744)",103
22.4599724,114.2009744,13,0,0,0,"(22.4599724, 114.2009744)",103
22.4599724,114.2009744,14,0,65,65,"(22.4599724, 114.2009744)",103
22.4599724,114.2009744,15,0,0,0,"(22.4599724, 114.2009744)",103
22.4599724,114.2009744,16,0,0,0,"(22.4599724, 114.2009744)",103
22.4599724,114.2009744,17,0,0,0,"(22.4599724, 114.2009744)",103
22.4599724,114.2009744,18,369,361,730,"(22.4599724, 114.2009744)",103
22.4599724,114.2009744,19,0,0,0,"(22.4599724, 114.2009744)",103
22.4599724,114.2009744,20,0,76,76,"(22.4599724, 114.2009744)",103
22.4599724,114.2009744,21,0,0,0,"(22.4599724, 114.2009744)",103
22.4599724,114.2009744,22,0,0,0,"(22.4599724, 114.2009744)",103
22.4599724,114.2009744,23,0,0,0,"(22.4599724, 114.2009744)",103
22.3861493,114.1929274,0,201,876,1077,"(22.3861493, 114.1929274)",104
22.3861493,114.1929274,1,259,100,359,"(22.3861493, 114.1929274)",104
22.3861493,114.1929274,2,0,146,146,"(22.3861493, 114.1929274)",104
22.3861493,114.1929274,3,0,0,0,"(22.3861493, 114.1929274)",104
22.3861493,114.1929274,4,0,0,0,"(22.3861493, 114.1929274)",104
22.3861493,114.1929274,5,115,0,115,"(22.3861493, 114.1929274)",104
22.3861493,114.1929274,6,0,0,0,"(22.3861493, 114.1929274)",104
22.3861493,114.1929274,7,948,390,1338,"(22.3861493, 114.1929274)",104
22.3861493,114.1929274,8,1553,2400,3953,"(22.3861493, 114.1929274)",104
22.3861493,114.1929274,9,584,803,1387,"(22.3861493, 114.1929274)",104
22.3861493,114.1929274,10,571,769,1340,"(22.3861493, 114.1929274)",104
22.3861493,114.1929274,11,464,217,681,"(22.3861493, 114.1929274)",104
22.3861493,114.1929274,12,849,716,1565,"(22.3861493, 114.1929274)",104
22.3861493,114.1929274,13,187,0,187,"(22.3861493, 114.1929274)",104
22.3861493,114.1929274,14,85,657,742,"(22.3861493, 114.1929274)",104
22.3861493,114.1929274,15,1304,305,1609,"(22.3861493, 114.1929274)",104
22.3861493,114.1929274,16,269,689,958,"(22.3861493, 114.1929274)",104
22.3861493,114.1929274,17,652,492,1144,"(22.3861493, 114.1929274)",104
22.3861493,114.1929274,18,1026,1605,2631,"(22.3861493, 114.1929274)",104
22.3861493,114.1929274,19,1215,1381,2596,"(22.3861493, 114.1929274)",104
22.3861493,114.1929274,20,332,745,1077,"(22.3861493, 114.1929274)",104
22.3861493,114.1929274,21,1147,769,1916,"(22.3861493, 114.1929274)",104
22.3861493,114.1929274,22,0,397,397,"(22.3861493, 114.1929274)",104
22.3861493,114.1929274,23,274,556,830,"(22.3861493, 114.1929274)",104
22.36901,114.177592,0,0,348,348,"(22.36901, 114.177592)",105
22.36901,114.177592,1,186,191,377,"(22.36901, 114.177592)",105
22.36901,114.177592,2,379,215,594,"(22.36901, 114.177592)",105
22.36901,114.177592,3,0,0,0,"(22.36901, 114.177592)",105
22.36901,114.177592,4,201,0,201,"(22.36901, 114.177592)",105
22.36901,114.177592,5,0,3,3,"(22.36901, 114.177592)",105
22.36901,114.177592,6,0,0,0,"(22.36901, 114.177592)",105
22.36901,114.177592,7,216,411,627,"(22.36901, 114.177592)",105
22.36901,114.177592,8,0,227,227,"(22.36901, 114.177592)",105
22.36901,114.177592,9,211,174,385,"(22.36901, 114.177592)",105
22.36901,114.177592,10,375,0,375,"(22.36901, 114.177592)",105
22.36901,114.177592,11,610,4,614,"(22.36901, 114.177592)",105
22.36901,114.177592,12,460,128,588,"(22.36901, 114.177592)",105
22.36901,114.177592,13,174,0,174,"(22.36901, 114.177592)",105
22.36901,114.177592,14,0,806,806,"(22.36901, 114.177592)",105
22.36901,114.177592,15,183,1151,1334,"(22.36901, 114.177592)",105
22.36901,114.177592,16,0,430,430,"(22.36901, 114.177592)",105
22.36901,114.177592,17,0,154,154,"(22.36901, 114.177592)",105
22.36901,114.177592,18,207,1227,1434,"(22.36901, 114.177592)",105
22.36901,114.177592,19,548,373,921,"(22.36901, 114.177592)",105
22.36901,114.177592,20,0,206,206,"(22.36901, 114.177592)",105
22.36901,114.177592,21,818,481,1299,"(22.36901, 114.177592)",105
22.36901,114.177592,22,0,46,46,"(22.36901, 114.177592)",105
22.36901,114.177592,23,0,404,404,"(22.36901, 114.177592)",105
